id,release_date,movie,production_budget,domestic_gross,worldwide_gross,release_year,release_month,ROI,net_revenue
1,2009-12-18,Avatar,425000000,760507625,2776345279,2009,12,553.26,2351345279
2,2011-05-20,Pirates of the Caribbean: On Stranger Tides,410600000,241063875,1045663875,2011,5,154.67,635063875
3,2019-06-07,Dark Phoenix,350000000,42762350,149762350,2019,6,-57.21,-200237650
4,2015-05-01,Avengers: Age of Ultron,330600000,459005868,1403013963,2015,5,324.38,1072413963
5,2017-12-15,Star Wars Ep. VIII: The Last Jedi,317000000,620181382,1316721747,2017,12,315.37,999721747
6,2015-12-18,Star Wars Ep. VII: The Force Awakens,306000000,936662225,2053311220,2015,12,571.02,1747311220
7,2018-04-27,Avengers: Infinity War,300000000,678815482,2048134200,2018,4,582.71,1748134200
8,2007-05-24,Pirates of the Caribbean: At Worldâs End,300000000,309420425,963420425,2007,5,221.14,663420425
9,2017-11-17,Justice League,300000000,229024295,655945209,2017,11,118.65,355945209
10,2015-11-06,Spectre,300000000,200074175,879620923,2015,11,193.21,579620923
11,2012-07-20,The Dark Knight Rises,275000000,448139099,1084439099,2012,7,294.34,809439099
12,2018-05-25,Solo: A Star Wars Story,275000000,213767512,393151347,2018,5,42.96,118151347
13,2013-07-02,The Lone Ranger,275000000,89302115,260002115,2013,7,-5.45,-14997885
14,2012-03-09,John Carter,275000000,73058679,282778100,2012,3,2.83,7778100
15,2010-11-24,Tangled,260000000,200821936,586477240,2010,11,125.57,326477240
16,2007-05-04,Spider-Man 3,258000000,336530303,894860230,2007,5,246.85,636860230
17,2016-05-06,Captain America: Civil War,250000000,408084349,1140069413,2016,5,356.03,890069413
18,2016-03-25,Batman v Superman: Dawn of Justice,250000000,330360194,867500281,2016,3,247.0,617500281
19,2012-12-14,The Hobbit: An Unexpected Journey,250000000,303003568,1017003568,2012,12,306.8,767003568
20,2009-07-15,Harry Potter and the Half-Blood Prince,250000000,302089278,935213767,2009,7,274.09,685213767
21,2013-12-13,The Hobbit: The Desolation of Smaug,250000000,258366855,960366855,2013,12,284.15,710366855
22,2014-12-17,The Hobbit: The Battle of the Five Armies,250000000,255119788,945577621,2014,12,278.23,695577621
23,2017-04-14,The Fate of the Furious,250000000,225764765,1234846267,2017,4,393.94,984846267
24,2006-06-28,Superman Returns,232000000,200120000,374085065,2006,6,61.24,142085065
25,2017-05-26,Pirates of the Caribbean: Dead Men Tell No Tales,230000000,172558876,788241137,2017,5,242.71,558241137
26,2008-11-14,Quantum of Solace,230000000,169368427,591692078,2008,11,157.26,361692078
27,2012-05-04,The Avengers,225000000,623279547,1517935897,2012,5,574.64,1292935897
28,2006-07-07,Pirates of the Caribbean: Dead Manâs Chest,225000000,423315812,1066215812,2006,7,373.87,841215812
29,2013-06-14,Man of Steel,225000000,291045518,667999518,2013,6,196.89,442999518
30,2008-05-16,The Chronicles of Narnia: Prince Caspian,225000000,141621490,417341288,2008,5,85.49,192341288
31,2012-07-03,The Amazing Spider-Man,220000000,262030663,757890267,2012,7,244.5,537890267
32,2012-05-18,Battleship,220000000,65233400,313477717,2012,5,42.49,93477717
33,2017-06-21,Transformers: The Last Knight,217000000,130168683,602893340,2017,6,177.83,385893340
34,2015-06-12,Jurassic World,215000000,652270625,1648854864,2015,6,666.91,1433854864
35,2012-05-25,Men in Black 3,215000000,179020854,654213485,2012,5,204.29,439213485
36,2009-06-24,Transformers: Revenge of the Fallen,210000000,402111870,836519699,2009,6,298.34,626519699
37,2014-06-27,Transformers: Age of Extinction,210000000,245439076,1104039076,2014,6,425.73,894039076
38,2006-05-26,X-Men: The Last Stand,210000000,234362462,459260946,2006,5,118.7,249260946
39,2010-05-14,Robin Hood,210000000,105487148,322459006,2010,5,53.55,112459006
40,2005-12-14,King Kong,207000000,218080025,550517357,2005,12,165.95,343517357
41,2007-12-07,The Golden Compass,205000000,70107728,367262558,2007,12,79.15,162262558
42,2018-02-16,Black Panther,200000000,700059566,1348258224,2018,2,574.13,1148258224
44,2018-06-15,Incredibles 2,200000000,608581744,1242520711,2018,6,521.26,1042520711
45,2016-12-16,Rogue One: A Star Wars Story,200000000,532177324,1049102856,2016,12,424.55,849102856
46,2016-06-17,Finding Dory,200000000,486295561,1021215193,2016,6,410.61,821215193
47,2010-06-18,Toy Story 3,200000000,415004880,1068879522,2010,6,434.44,868879522
48,2013-05-03,Iron Man 3,200000000,408992272,1215392272,2013,5,507.7,1015392272
49,2017-05-05,Guardians of the Galaxy Vol 2,200000000,389813101,862316233,2017,5,331.16,662316233
50,2004-06-30,Spider-Man 2,200000000,373524485,795110670,2004,6,297.56,595110670
51,2010-03-05,Alice in Wonderland,200000000,334191110,1025491110,2010,3,412.75,825491110
52,2012-11-08,Skyfall,200000000,304360277,1110526981,2012,11,455.26,910526981
53,2013-06-21,Monsters University,200000000,268488329,743588329,2013,6,271.79,543588329
54,2013-03-08,Oz the Great and Powerful,200000000,234770996,490359051,2013,3,145.18,290359051
55,2014-05-23,X-Men: Days of Future Past,200000000,233921534,747862775,2014,5,273.93,547862775
56,2014-05-02,The Amazing Spider-Man 2,200000000,202853933,708996336,2014,5,254.5,508996336
57,2011-06-24,Cars 2,200000000,191450875,560155383,2011,6,180.08,360155383
58,2010-12-17,Tron: Legacy,200000000,172062763,400062763,2010,12,100.03,200062763
59,2009-11-13,2012,200000000,166112167,757677748,2009,11,278.84,557677748
60,2018-11-16,Fantastic Beasts: The Crimes of Grindelwald,200000000,159555901,652220086,2018,11,226.11,452220086
61,2009-05-21,Terminator Salvation,200000000,125322469,365491792,2009,5,82.75,165491792
62,2011-06-17,Green Lantern,200000000,116601172,219535492,2011,6,9.77,19535492
63,2010-05-28,Prince of Persia: Sands of Time,200000000,90759676,336359676,2010,5,68.18,136359676
64,2011-06-29,Transformers: Dark of the Moon,195000000,352390543,1123790543,2011,6,476.3,928790543
65,2017-06-09,The Mummy,195000000,80101125,409953905,2017,6,110.23,214953905
66,2013-03-01,Jack the Giant Slayer,195000000,65187603,197687603,2013,3,1.38,2687603
67,2015-04-03,Furious 7,190000000,353007020,1518722794,2015,4,699.33,1328722794
68,2013-05-16,Star Trek Into Darkness,190000000,228778661,467381584,2013,5,145.99,277381584
69,2013-06-21,World War Z,190000000,202359711,531514650,2013,6,179.74,341514650
70,2013-05-10,The Great Gatsby,190000000,144840419,351040419,2013,5,84.76,161040419
71,2009-11-06,Disneyâs A Christmas Carol,190000000,137855863,315709697,2009,11,66.16,125709697
72,2013-07-12,Pacific Rim,190000000,101802906,411002906,2013,7,116.32,221002906
73,2015-11-25,The Good Dinosaur,187500000,123087120,333771037,2015,11,78.01,146271037
74,2008-05-02,Iron Man,186000000,318604126,585171547,2008,5,214.61,399171547
75,2008-07-18,The Dark Knight,185000000,533720947,1001996207,2008,7,441.62,816996207
76,2008-05-22,Indiana Jones and the Kingdom of the Crystal Skull,185000000,317101119,786635413,2008,5,325.21,601635413
77,2012-06-22,Brave,185000000,237282182,554606532,2012,6,199.79,369606532
78,2017-03-10,Kong: Skull Island,185000000,168052812,561072059,2017,3,203.28,376072059
79,2016-07-22,Star Trek Beyond,185000000,158848340,335802233,2016,7,81.51,150802233
80,2017-10-06,Blade Runner 2049,185000000,92054159,259357408,2017,10,40.19,74357408
81,2019-05-24,Aladdin,182000000,246734314,619234314,2019,5,240.24,437234314
82,2017-11-03,Thor: Ragnarok,180000000,315058289,846980024,2017,11,370.54,666980024
83,2005-12-09,"The Chronicles of Narnia: The Lion, the Witch and the Wardrobe",180000000,291710957,720539572,2005,12,300.3,540539572
84,2014-05-30,Maleficent,180000000,241407328,758536735,2014,5,321.41,578536735
85,2016-11-18,Fantastic Beasts and Where to Find Them,180000000,234037575,802402853,2016,11,345.78,622402853
86,2008-06-27,WALL-E,180000000,223808164,532508025,2008,6,195.84,352508025
87,2007-08-10,Rush Hour 3,180000000,140125968,256585882,2007,8,42.55,76585882
88,2016-07-01,The Legend of Tarzan,180000000,126643061,348902025,2016,7,93.83,168902025
89,2011-11-23,Hugo,180000000,73864507,180047784,2011,11,0.03,47784
90,2017-07-21,Valerian and the City of a Thousand Planets,180000000,40479370,215098356,2017,7,19.5,35098356
91,2015-02-06,Jupiter Ascending,179000000,47482519,181982519,2015,2,1.67,2982519
92,2018-07-27,Mission: ImpossibleâFallout,178000000,220159104,787456552,2018,7,342.39,609456552
93,2016-05-27,X-Men: Apocalypse,178000000,155442489,542537546,2016,5,204.8,364537546
94,2018-08-10,The Meg,178000000,145443742,529530715,2018,8,197.49,351530715
95,2014-06-06,Edge of Tomorrow,178000000,100206256,370541256,2014,6,108.17,192541256
96,2019-03-08,Captain Marvel,175000000,426525952,1123061550,2019,3,541.75,948061550
97,2016-04-15,The Jungle Book,175000000,364001123,962854547,2016,4,450.2,787854547
98,2015-06-19,Inside Out,175000000,356461711,854235992,2015,6,388.13,679235992
99,2017-07-07,Spider-Man: Homecoming,175000000,334201140,880166350,2017,7,402.95,705166350
100,2016-08-05,Suicide Squad,175000000,325100054,746059887,2016,8,326.32,571059887
1,2009-05-29,Up,175000000,293004164,731463377,2009,5,317.98,556463377
2,2017-11-22,Coco,175000000,209726015,798008101,2017,11,356.0,623008101
3,2018-11-21,Ralph Breaks The Internet,175000000,201091711,524283695,2018,11,199.59,349283695
4,2009-03-27,Monsters vs. Aliens,175000000,198351526,381687380,2009,3,118.11,206687380
5,2017-06-16,Cars 3,175000000,152901115,383541369,2017,6,119.17,208541369
6,2009-08-07,G.I. Joe: The Rise of Cobra,175000000,150201498,302469017,2009,8,72.84,127469017
8,2008-08-01,The Mummy: Tomb of the Dragon Emperor,175000000,102491776,405760225,2008,8,131.86,230760225
9,2007-06-22,Evan Almighty,175000000,100289690,174131329,2007,6,-0.5,-868671
11,2017-05-12,King Arthur: Legend of the Sword,175000000,39175066,139630336,2017,5,-20.21,-35369664
12,2013-12-25,47 Ronin,175000000,38362475,151716815,2013,12,-13.3,-23283185
13,2018-06-22,Jurassic World: Fallen Kingdom,170000000,417719760,1305772799,2018,6,668.1,1135772799
14,2014-08-01,Guardians of the Galaxy,170000000,333172112,770867516,2014,8,353.45,600867516
15,2010-05-07,Iron Man 2,170000000,312433331,621156389,2010,5,265.39,451156389
16,2014-04-04,Captain America: The Winter Soldier,170000000,259746958,714401889,2014,4,320.24,544401889
17,2014-07-11,Dawn of the Planet of the Apes,170000000,208545589,710644566,2014,7,318.03,540644566
18,2004-11-10,The Polar Express,170000000,187224605,311365187,2004,11,83.16,141365187
19,2012-06-01,Snow White and the Huntsman,170000000,155136755,401021746,2012,6,135.9,231021746
20,2003-07-01,Terminator 3: Rise of the Machines,170000000,150358296,433058296,2003,7,154.74,263058296
21,2004-05-07,Van Helsing,170000000,120150546,300150546,2004,5,76.56,130150546
22,2019-03-29,Dumbo,170000000,113883318,345004422,2019,3,102.94,175004422
23,2015-05-22,Tomorrowland,170000000,93436322,206627518,2015,5,21.55,36627518
24,2019-02-14,Alita: Battle Angel,170000000,85710210,402976036,2019,2,137.04,232976036
25,2019-05-31,Godzilla: King of the Monsters,170000000,85576941,299276941,2019,5,76.05,129276941
26,2016-05-27,Alice Through the Looking Glass,170000000,77042381,276928112,2016,5,62.9,106928112
27,2010-05-21,Shrek Forever After,165000000,238736787,756244673,2010,5,358.33,591244673
28,2016-11-04,Doctor Strange,165000000,232641920,676404566,2016,11,309.94,511404566
29,2014-11-07,Big Hero 6,165000000,222527828,652127828,2014,11,295.23,487127828
30,2010-03-26,How to Train Your Dragon,165000000,217581232,494870992,2010,3,199.92,329870992
31,2012-11-02,Wreck-It Ralph,165000000,189412677,496511521,2012,11,200.92,331511521
32,2014-11-05,Interstellar,165000000,188017894,666379375,2014,11,303.87,501379375
33,2016-06-24,Independence Day: Resurgence,165000000,103144286,384169424,2016,6,132.83,219169424
34,2011-07-29,Cowboys and Aliens,163000000,100368560,176038324,2011,7,8.0,13038324
35,2017-03-17,Beauty and the Beast,160000000,504014165,1259199706,2017,3,687.0,1099199706
36,2018-12-21,Aquaman,160000000,335061807,1146894640,2018,12,616.81,986894640
37,2007-05-17,Shrek the Third,160000000,322719944,807330936,2007,5,404.58,647330936
38,2010-07-16,Inception,160000000,292576195,835524642,2010,7,422.2,675524642
39,2015-11-20,The Hunger Games: Mockingjay - Part 2,160000000,281723902,648986787,2015,11,305.62,488986787
40,2013-05-24,Fast and Furious 6,160000000,238679850,789300444,2013,5,393.31,629300444
41,2014-05-16,Godzilla,160000000,200676069,529076069,2014,5,230.67,369076069
42,2011-06-03,X-Men: First Class,160000000,146408305,355408305,2011,6,122.13,195408305
43,2008-12-25,The Curious Case of Benjamin Button,160000000,127509326,329631958,2008,12,106.02,169631958
44,2010-07-14,The Sorcerer's Apprentice,160000000,63150991,217986320,2010,7,36.24,57986320
45,2006-05-12,Poseidon,160000000,60674817,181674817,2006,5,13.55,21674817
46,2016-06-10,Warcraft,160000000,47225655,425522281,2016,6,165.95,265522281
47,2016-09-30,Deepwater Horizon,156000000,61433527,122603824,2016,9,-21.41,-33396176
48,2010-12-10,The Chronicles of Narnia: The Voyage of the Dawn Treader,155000000,104386950,418186950,2010,12,169.8,263186950
49,2015-07-01,Terminator: Genisys,155000000,89760956,432150894,2015,7,178.81,277150894
50,2018-03-23,Pacific Rim: Uprising,155000000,59874525,290930148,2018,3,87.7,135930148
51,2004-11-24,Alexander,155000000,34297191,167297191,2004,11,7.93,12297191
52,2017-07-14,War for the Planet of the Apes,152000000,146880162,489592267,2017,7,222.1,337592267
53,2001-05-25,Pearl Harbor,151500000,198539855,449239855,2001,5,196.53,297739855
54,2007-07-02,Transformers,151000000,319246193,708272592,2007,7,369.05,557272592
55,2017-06-02,Wonder Woman,150000000,412563408,821133378,2017,6,447.42,671133378
56,2013-11-22,Frozen,150000000,400738009,1272469910,2013,11,748.31,1122469910
57,2016-03-04,Zootopia,150000000,341268248,1019429616,2016,3,579.62,869429616
58,2007-07-11,Harry Potter and the Order of the Phoenix,150000000,292137260,943076457,2007,7,528.72,793076457
59,2005-11-18,Harry Potter and the Goblet of Fire,150000000,290201752,897099794,2005,11,498.07,747099794
60,2003-05-15,The Matrix Reloaded,150000000,281553689,738576929,2003,5,392.38,588576929
61,2007-12-14,I am Legend,150000000,256393010,585532684,2007,12,290.36,435532684
62,2016-11-23,Moana,150000000,248757044,637517365,2016,11,325.01,487517365
63,2008-07-01,Hancock,150000000,227946274,624234272,2008,7,316.16,474234272
64,2005-07-15,Charlie and the Chocolate Factory,150000000,206459076,475825484,2005,7,217.22,325825484
65,2007-06-29,Ratatouille,150000000,206445654,626549695,2007,6,317.7,476549695
66,2013-11-08,Thor: The Dark World,150000000,206362140,644602516,2013,11,329.74,494602516
67,2005-06-15,Batman Begins,150000000,205343774,359142722,2005,6,139.43,209142722
68,2015-07-31,Mission: ImpossibleâRogue Nation,150000000,195042377,688858992,2015,7,359.24,538858992
69,2017-07-21,Dunkirk,150000000,190068280,499837368,2017,7,233.22,349837368
70,2011-05-06,Thor,150000000,181030624,449326618,2011,5,199.55,299326618
71,2008-11-07,Madagascar: Escape 2 Africa,150000000,180174880,599680774,2008,11,299.79,449680774
72,2009-05-01,X-Men Origins: Wolverine,150000000,179883157,374825760,2009,5,149.88,224825760
73,2009-05-22,Night at the Museum: Battle of the Smithsonian,150000000,177243721,402231063,2009,5,168.15,252231063
74,2011-05-26,Kung Fu Panda 2,150000000,165249063,664837547,2011,5,343.23,514837547
75,2015-05-15,Mad Max: Fury Road,150000000,153636354,370098020,2015,5,146.73,220098020
76,2019-05-10,PokÃ©mon: Detective Pikachu,150000000,139507806,411258433,2019,5,174.17,261258433
77,2003-11-05,The Matrix Revolutions,150000000,139270910,427300260,2003,11,184.87,277300260
78,2018-03-29,Ready Player One,150000000,137690172,579290136,2018,3,286.19,429290136
79,2005-11-04,Chicken Little,150000000,135386665,310043823,2005,11,106.7,160043823
80,2006-05-05,Mission: Impossible III,150000000,133501348,397501348,2006,5,165.0,247501348
81,2009-05-15,Angels & Demons,150000000,133375846,490875846,2009,5,227.25,340875846
82,2004-05-14,Troy,150000000,133298577,484161265,2004,5,222.77,334161265
83,2010-07-01,The Last Airbender,150000000,131772187,319713881,2010,7,113.14,169713881
84,2007-11-02,Bee Movie,150000000,126631277,287594577,2007,11,91.73,137594577
85,2009-07-24,G-Force,150000000,119436770,292817841,2009,7,95.21,142817841
86,2008-11-21,Bolt,150000000,114053579,328015029,2008,11,118.68,178015029
87,2012-03-30,Wrath of the Titans,150000000,83670083,305270083,2012,3,103.51,155270083
88,2007-11-16,Beowulf,150000000,82280579,195080579,2007,11,30.05,45080579
89,2012-05-11,Dark Shadows,150000000,79727149,238202668,2012,5,58.8,88202668
90,2013-06-28,White House Down,150000000,73103784,205440387,2013,6,36.96,55440387
91,2010-02-12,The Wolfman,150000000,62189884,142634358,2010,2,-4.91,-7365642
92,2017-02-17,The Great Wall,150000000,45157105,334486852,2017,2,122.99,184486852
93,2015-10-09,Pan,150000000,35088320,151525973,2015,10,1.02,1525973
94,2011-03-11,Mars Needs Moms,150000000,21392758,39549758,2011,3,-73.63,-110450242
96,2006-11-03,Flushed Away,149000000,64665672,179357126,2006,11,20.37,30357126
97,2012-06-08,Madagascar 3: Europe's Most Wanted,145000000,216391482,746921271,2012,6,415.12,601921271
98,2011-12-16,Mission: ImpossibleâGhost Protocol,145000000,209397903,694713230,2011,12,379.11,549713230
99,2014-06-13,How to Train Your Dragon 2,145000000,177002924,614586270,2014,6,323.85,469586270
1,2014-03-07,Mr. Peabody & Sherman,145000000,111506430,269806430,2014,3,86.07,124806430
2,2012-11-21,Rise of the Guardians,145000000,103412758,306900902,2012,11,111.66,161900902
3,2005-04-08,Sahara,145000000,68671925,121671925,2005,4,-16.09,-23328075
4,2016-07-15,Ghostbusters,144000000,128350574,229008658,2016,7,59.03,85008658
5,2002-11-22,Die Another Day,142000000,160942139,431942139,2002,11,204.18,289942139
6,2003-07-09,Pirates of the Caribbean: The Curse of the Black Pearl,140000000,305411224,634954103,2003,7,353.54,494954103
7,2009-05-08,Star Trek,140000000,257730019,386839614,2009,5,176.31,246839614
9,2002-07-03,Men in Black 2,140000000,190418803,441767803,2002,7,215.55,301767803
10,2011-07-22,Captain America: The First Avenger,140000000,176654505,370569776,2011,7,164.69,230569776
11,2016-01-29,Kung Fu Panda 3,140000000,143528619,517599142,2016,1,269.71,377599142
13,2013-03-27,G.I. Joe: Retaliation,140000000,122523060,375740705,2013,3,168.39,235740705
14,2003-12-05,The Last Samurai,140000000,111110575,456810575,2003,12,226.29,316810575
15,2005-12-21,Fun With Dick And Jane,140000000,110550000,203018919,2005,12,45.01,63018919
16,2014-12-12,Exodus: Gods and Kings,140000000,65014513,268314513,2014,12,91.65,128314513
17,2016-07-01,The BFG,140000000,55483770,199646680,2016,7,42.6,59646680
18,2016-02-26,Gods of Egypt,140000000,31153464,138836756,2016,2,-0.83,-1163244
19,2002-05-03,Spider-Man,139000000,403706375,821706375,2002,5,491.16,682706375
20,2009-03-06,Watchmen,138000000,107509799,186976250,2009,3,35.49,48976250
21,2005-07-29,Stealth,138000000,32116746,76416746,2005,7,-44.63,-61583254
22,2008-06-13,The Incredible Hulk,137500000,134806913,265573859,2008,6,93.14,128073859
23,2003-06-20,Hulk,137000000,132177234,245075434,2003,6,78.89,108075434
24,2001-07-11,Final Fantasy: The Spirits Within,137000000,32131830,85131830,2001,7,-37.86,-51868170
25,2012-11-16,"The Twilight Saga: Breaking Dawn, Part 2",136200000,292324737,829724737,2012,11,509.2,693524737
26,2013-03-22,The Croods,135000000,187168425,573068425,2013,3,324.5,438068425
27,2015-12-25,The Revenant,135000000,183637894,532938302,2015,12,294.77,397938302
29,2011-03-04,Rango,135000000,123477607,245724600,2011,3,82.02,110724600
30,2003-11-14,Master and Commander: The Far Side of the World,135000000,93926386,212912137,2003,11,57.71,77912137
31,2013-07-17,Turbo,135000000,83028130,286896578,2013,7,112.52,151896578
32,2016-06-03,Teenage Mutant Ninja Turtles: Out of the Shadows,135000000,82051601,245328374,2016,6,81.72,110328374
33,2011-11-18,Happy Feet Two,135000000,64006466,157956466,2011,11,17.0,22956466
34,2006-07-28,Miami Vice,135000000,63478838,163818556,2006,7,21.35,28818556
35,2018-11-02,The Nutcracker and the Four Realms,132900000,54858851,170293899,2018,11,28.14,37393899
36,2005-06-29,War of the Worlds,132000000,234280354,606836535,2005,6,359.72,474836535
37,2014-11-26,Penguins of Madagascar,132000000,83350911,366942531,2014,11,177.99,234942531
38,2013-11-22,The Hunger Games: Catching Fire,130000000,424668047,864868047,2013,11,565.28,734868047
39,2004-06-04,Harry Potter and the Prisoner of Azkaban,130000000,249757726,796907323,2004,6,513.01,666907323
40,2007-08-03,The Bourne Ultimatum,130000000,227471070,444043396,2007,8,241.57,314043396
41,2018-07-06,Ant-Man and the Wasp,130000000,216648740,623144660,2018,7,379.34,493144660
42,2008-06-06,Kung Fu Panda,130000000,215434591,631910531,2008,6,386.09,501910531
43,2015-07-17,Ant-Man,130000000,180202163,518858449,2015,7,299.12,388858449
44,2015-03-27,Home,130000000,177397510,385997896,2015,3,196.92,255997896
45,2018-12-19,Mary Poppins Returns,130000000,171958438,341528518,2018,12,162.71,211528518
46,2011-10-28,Puss in Boots,130000000,149260504,554987477,2011,10,326.91,424987477
47,2010-11-05,Megamind,130000000,148415853,321887208,2010,11,147.61,191887208
48,2003-07-18,Bad Boys II,130000000,138540870,273271982,2003,7,110.21,143271982
49,2014-04-11,Rio 2,130000000,131538435,492846291,2014,4,279.11,362846291
50,2010-07-23,Salt,130000000,118311368,290650494,2010,7,123.58,160650494
51,2014-03-28,Noah,130000000,101200044,352831065,2014,3,171.41,222831065
52,2011-12-21,The Adventures of Tintin,130000000,77591831,373993951,2011,12,187.69,243993951
53,2013-05-31,After Earth,130000000,60522097,251499665,2013,5,93.46,121499665
54,2008-11-26,Australia,130000000,49554002,215080810,2008,11,65.45,85080810
55,2013-07-19,R.I.P.D.,130000000,33618855,79076678,2013,7,-39.17,-50923322
56,2019-02-22,How to Train Your Dragon: The Hidden World,129000000,160791800,519258283,2019,2,302.53,390258283
57,2011-11-18,"The Twilight Saga: Breaking Dawn, Part 1",127500000,281287133,689420051,2011,11,440.72,561920051
58,2000-05-19,Dinosaur,127500000,137748063,356148063,2000,5,179.33,228648063
59,2017-03-03,Logan,127000000,226277068,615461394,2017,3,384.62,488461394
60,2014-12-19,Night at the Museum: Secret of the Tomb,127000000,113746621,353756621,2014,12,178.55,226756621
61,2011-07-15,Harry Potter and the Deathly Hallows: Part II,125000000,381193157,1341693157,2011,7,973.35,1216693157
62,2014-11-21,The Hunger Games: Mockingjay - Part 1,125000000,337135885,766575131,2014,11,513.26,641575131
63,2001-11-16,Harry Potter and the Sorcererâs Stone,125000000,317871467,975047606,2001,11,680.04,850047606
64,2010-11-19,Harry Potter and the Deathly Hallows: Part I,125000000,296131568,960431568,2010,11,668.35,835431568
65,2006-05-19,The Da Vinci Code,125000000,217536138,767820459,2006,5,514.26,642820459
66,2003-05-02,X-Men 2,125000000,214949694,406875536,2003,5,225.5,281875536
67,2011-04-29,Fast Five,125000000,210031325,630163454,2011,4,404.13,505163454
68,2014-08-08,Teenage Mutant Ninja Turtles,125000000,191204754,485004754,2014,8,288.0,360004754
69,2011-12-16,Sherlock Holmes: A Game of Shadows,125000000,186848418,535663443,2011,12,328.53,410663443
70,2004-05-28,The Day After Tomorrow,125000000,186740799,556319450,2004,5,345.06,431319450
71,2017-03-31,The Boss Baby,125000000,175003033,510878762,2017,3,308.7,385878762
72,2010-04-01,Clash of the Titans,125000000,163214888,493214888,2010,4,294.57,368214888
73,2016-11-04,Trolls,125000000,153707064,344150134,2016,11,175.32,219150134
75,2012-06-08,Prometheus,125000000,126477084,402448265,2012,6,221.96,277448265
76,2012-08-10,The Bourne Legacy,125000000,113203870,280355920,2012,8,124.28,155355920
78,2018-07-13,Skyscraper,125000000,68420120,304115534,2018,7,143.29,179115534
79,2012-08-03,Total Recall,125000000,58877969,211856088,2012,8,69.48,86856088
80,2016-12-21,Assassinâs Creed,125000000,54647948,240759682,2016,12,92.61,115759682
81,2017-01-13,Monster Trucks,125000000,33370166,61642798,2017,1,-50.69,-63357202
83,2000-11-17,How the Grinch Stole Christmas,123000000,260044825,345141403,2000,11,180.6,222141403
84,2000-05-24,Mission: Impossible 2,120000000,215409889,549588516,2000,5,357.99,429588516
85,2000-06-30,The Perfect Storm,120000000,182618434,328711434,2000,6,173.93,208711434
86,2016-07-29,Jason Bourne,120000000,162192920,416168316,2016,7,246.81,296168316
87,2007-06-15,Fantastic Four: Rise of the Silver Surfer,120000000,131921738,289480691,2007,6,141.23,169480691
88,2012-11-21,Life of Pi,120000000,124987022,620912003,2012,11,417.43,500912003
89,2007-02-16,Ghost Rider,120000000,115802596,229545589,2007,2,91.29,109545589
90,2018-04-13,Rampage,120000000,101028233,428056280,2018,4,256.71,308056280
91,2003-06-27,Charlie's Angels: Full Throttle,120000000,100814328,227200000,2003,6,89.33,107200000
92,2013-08-09,Elysium,120000000,93050117,286192091,2013,8,138.49,166192091
93,2013-04-19,Oblivion,120000000,89107235,287916633,2013,4,139.93,167916633
94,2017-03-24,Power Rangers,120000000,85364450,142531552,2017,3,18.78,22531552
95,2002-07-19,Stuart Little 2,120000000,64956806,166000000,2002,7,38.33,46000000
96,2014-02-12,RoboCop,120000000,58607007,242981799,2014,2,102.48,122981799
97,2004-06-11,The Chronicles of Riddick,120000000,57712751,107212751,2004,6,-10.66,-12787249
98,2015-08-07,Fantastic Four,120000000,56117548,167849187,2015,8,39.87,47849187
99,2008-05-09,Speed Racer,120000000,43945766,93394462,2008,5,-22.17,-26605538
100,2005-07-22,The Island,120000000,35818913,163018913,2005,7,35.85,43018913
1,2010-12-17,How Do You Know?,120000000,30212620,49628177,2010,12,-58.64,-70371823
2,2010-06-23,Knight and Day,117000000,76423035,258751370,2010,6,121.16,141751370
3,2018-10-05,Venom,116000000,213511408,853628605,2018,10,635.89,737628605
5,2005-05-19,Star Wars Ep. III: Revenge of the Sith,115000000,380270577,848998877,2005,5,638.26,733998877
6,2002-05-16,Star Wars Ep. II: Attack of the Clones,115000000,310676740,656695615,2002,5,471.04,541695615
7,2001-11-02,"Monsters, Inc.",115000000,289423425,559757719,2001,11,386.75,444757719
8,2013-07-26,The Wolverine,115000000,132556852,416456852,2013,7,262.14,301456852
10,2016-04-22,The Huntsman: Winterâs War,115000000,48003015,165149302,2016,4,43.61,50149302
11,2002-06-14,Windtalkers,115000000,40914068,77628265,2002,6,-32.5,-37371735
12,2008-07-04,AstÃ©rix aux Jeux Olympiques,113500000,999811,132999811,2008,7,17.18,19499811
13,2010-12-25,Gulliver's Travels,112000000,42779261,232017848,2010,12,107.16,120017848
14,2017-12-15,Ferdinand,111000000,84410380,289847930,2017,12,161.12,178847930
15,2018-05-18,Deadpool 2,110000000,324591735,786680557,2018,5,615.16,676680557
16,2013-10-04,Gravity,110000000,274092705,693698673,2013,10,530.64,583698673
17,2006-12-22,Night at the Museum,110000000,250863268,579446407,2006,12,426.77,469446407
18,2005-06-10,Mr. and Mrs. Smith,110000000,186336279,486124090,2005,6,341.93,376124090
19,2015-05-29,San Andreas,110000000,155190832,456258539,2015,5,314.78,346258539
20,2011-07-29,The Smurfs,110000000,142614158,563749323,2011,7,412.5,453749323
21,2007-06-27,Live Free or Die Hard,110000000,134529403,382288147,2007,6,247.53,272288147
22,2015-03-20,The Divergent Series: Insurgent,110000000,130179072,295075882,2015,3,168.25,185075882
23,2004-12-10,Ocean's Twelve,110000000,125531634,362989076,2004,12,229.99,252989076
25,2000-06-28,The Patriot,110000000,113330342,215300000,2000,6,95.73,105300000
26,2014-03-07,300: Rise of an Empire,110000000,106580051,330780051,2014,3,200.71,220780051
27,2004-12-17,The Aviator,110000000,102608827,208370892,2004,12,89.43,98370892
28,2016-12-21,Passengers,110000000,100014699,302239672,2016,12,174.76,192239672
29,2011-01-14,The Green Hornet,110000000,98780042,229155503,2011,1,108.32,119155503
30,2016-09-30,Miss Peregrineâs Home for Peculiar Children,110000000,87242834,295986876,2016,9,169.08,185986876
31,2011-10-07,Real Steel,110000000,85463309,263880341,2011,10,139.89,153880341
32,2010-06-11,The A-Team,110000000,77222099,177241171,2010,6,61.13,67241171
33,2013-07-31,The Smurfs 2,110000000,71017784,348547523,2013,7,216.86,238547523
34,2016-03-18,The Divergent Series: Allegiant,110000000,66184051,172022517,2016,3,56.38,62022517
35,2009-06-12,The Taking of Pelham 123,110000000,65452312,152364370,2009,6,38.51,42364370
36,2013-11-01,Ender's Game,110000000,61737191,127983283,2013,11,16.35,17983283
37,2004-04-02,Home on the Range,110000000,50026353,76482461,2004,4,-30.47,-33517539
39,2005-05-06,Kingdom of Heaven,110000000,47398413,218853353,2005,5,98.96,108853353
40,2017-03-31,Ghost in the Shell,110000000,40563557,167910690,2017,3,52.65,57910690
41,2004-06-16,Around the World in 80 Days,110000000,24004159,72004159,2004,6,-34.54,-37995841
42,2019-06-14,Men in Black: International,110000000,3100000,3100000,2019,6,-97.18,-106900000
43,2001-12-19,The Lord of the Rings: The Fellowship of the Ring,109000000,315544750,887210985,2001,12,713.96,778210985
44,2003-11-21,The Cat in the Hat,109000000,101018283,133818283,2003,11,22.77,24818283
45,2001-12-25,Ali,109000000,58183966,87683966,2001,12,-19.56,-21316034
46,2015-10-02,The Martian,108000000,228433663,655271443,2015,10,506.73,547271443
47,2016-11-23,Allied,106000000,40098064,119266661,2016,11,12.52,13266661
48,2004-07-16,"I, Robot",105000000,144801023,348629585,2004,7,232.03,243629585
50,2009-11-25,The Princess and the Frog,105000000,104400899,270997378,2009,11,158.09,165997378
51,2008-03-07,"10,000 B.C.",105000000,94784201,269065678,2008,3,156.25,164065678
52,2016-07-22,Ice Age: Collision Course,105000000,64063008,402156682,2016,7,283.01,297156682
53,2001-04-27,Town & Country,105000000,6712451,10364769,2001,4,-90.13,-94635231
54,2017-09-22,Kingsman: The Golden Circle,104000000,100234838,408803696,2017,9,293.08,304803696
55,2000-06-09,Gone in 60 Seconds,103300000,101643008,232643008,2000,6,125.21,129343008
56,2000-05-05,Gladiator,103000000,187683805,457683805,2000,5,344.35,354683805
57,2013-05-23,The Hangover 3,103000000,112200072,362000072,2013,5,251.46,259000072
58,2018-03-09,A Wrinkle in Time,103000000,100478608,133401882,2018,3,29.52,30401882
59,2009-07-01,Public Enemies,102500000,97104620,212282709,2009,7,107.11,109782709
60,2006-11-17,Casino Royale,102000000,167365000,594420283,2006,11,482.76,492420283
61,2002-06-21,Minority Report,102000000,132024714,358824714,2002,6,251.79,256824714
62,2018-12-21,Bumblebee,102000000,127195589,465195589,2018,12,356.07,363195589
63,2012-10-26,Cloud Atlas,102000000,27108272,130673154,2012,10,28.11,28673154
64,2002-11-15,Harry Potter and the Chamber of Secrets,100000000,262233381,879225135,2002,11,779.23,779225135
67,2001-07-27,Planet of the Apes,100000000,180011740,362211740,2001,7,262.21,262211740
68,2004-11-19,National Treasure,100000000,173005002,331323410,2004,11,231.32,231323410
69,2012-12-25,Django Unchained,100000000,162805434,449948323,2012,12,349.95,349948323
70,2010-12-22,Little Fockers,100000000,148438600,310650574,2010,12,210.65,210650574
72,2007-11-02,American Gangster,100000000,130164645,267985456,2007,11,167.99,167985456
73,2009-09-18,Cloudy with a Chance of Meatballs,100000000,124870275,236827677,2009,9,136.83,136827677
74,2010-08-06,The Other Guys,100000000,119219978,170936470,2010,8,70.94,70936470
75,2004-12-17,Lemony Snicket's A Series of Unfortunate Events,100000000,118627117,212956024,2004,12,112.96,112956024
76,2013-12-25,The Wolf of Wall Street,100000000,116900694,389870414,2013,12,289.87,289870414
77,2013-05-24,Epic,100000000,107518682,262794441,2013,5,162.79,162794441
80,2000-12-15,The Emperor's New Groove,100000000,89296573,169296573,2000,12,69.3,69296573
81,2012-08-17,The Expendables 2,100000000,85028192,311979256,2012,8,211.98,211979256
82,2009-10-16,Where the Wild Things Are,100000000,77233467,99123656,2009,10,-0.88,-876344
83,2006-12-15,Eragon,100000000,75030163,249488115,2006,12,149.49,149488115
84,2014-07-25,Hercules,100000000,72688614,243388614,2014,7,143.39,143388614
85,2010-12-10,The Tourist,100000000,67631157,278731369,2010,12,178.73,178731369
87,2004-06-11,The Stepford Wives,100000000,59475623,96221971,2004,6,-3.78,-3778029
88,2007-06-08,Surf's Up,100000000,58867694,145395745,2007,6,45.4,45395745
89,2006-12-08,Blood Diamond,100000000,57377916,171377916,2006,12,71.38,71377916
90,2010-09-24,Legend of the Guardians: The Owls of Ga'Hoole,100000000,55675313,139716717,2010,9,39.72,39716717
92,2009-06-05,Land of the Lost,100000000,49438370,69548641,2009,6,-30.45,-30451359
93,2003-12-25,Peter Pan,100000000,48417850,95255485,2003,12,-4.74,-4744515
94,2019-03-15,Wonder Park,100000000,45216793,115149422,2019,3,15.15,15149422
95,2004-07-23,Catwoman,100000000,40202379,82145379,2004,7,-17.85,-17854621
96,2014-08-15,The Expendables 3,100000000,39322544,209461378,2014,8,109.46,109461378
97,2002-11-27,Treasure Planet,100000000,38120554,91800000,2002,11,-8.2,-8200000
98,2010-03-12,Green Zone,100000000,35497337,97523020,2010,3,-2.48,-2476980
99,2017-10-20,Geostorm,100000000,33700160,220796009,2017,10,120.8,120796009
100,2015-12-25,Point Break,100000000,28782481,126704591,2015,12,26.7,26704591
1,2015-12-11,In the Heart of the Sea,100000000,25020758,89693309,2015,12,-10.31,-10306691
2,2014-04-18,Transcendence,100000000,23022309,103039258,2014,4,3.04,3039258
3,2005-02-18,Son of the Mask,100000000,17018422,59918422,2005,2,-40.08,-40081578
4,2018-12-14,Mortal Engines,100000000,15951040,85287417,2018,12,-14.71,-14712583
5,2002-08-16,The Adventures of Pluto Nash,100000000,4411102,7094995,2002,8,-92.91,-92905005
6,2012-01-20,Jin lÃ­ng shÃ­ san chai,100000000,311434,98227017,2012,1,-1.77,-1772983
7,2015-11-06,The Peanuts Movie,99000000,130178411,250091610,2015,11,152.62,151091610
8,2019-02-08,The LEGO Movie 2: The Second Part,99000000,105806508,190325698,2019,2,92.25,91325698
9,2018-11-21,Robin Hood,99000000,30824628,84747441,2018,11,-14.4,-14252559
10,2001-05-04,The Mummy Returns,98000000,202007640,435040395,2001,5,343.92,337040395
11,2002-12-20,Gangs of New York,97000000,77730500,183124621,2002,12,88.79,86124621
12,2017-05-19,Alien: Covenant,97000000,74262031,238521247,2017,5,145.9,141521247
13,2015-03-13,Cinderella,95000000,201151353,534551353,2015,3,462.69,439551353
14,2012-07-13,Ice Age: Continental Drift,95000000,161321843,879765137,2012,7,826.07,784765137
15,2001-12-28,Black Hawk Down,95000000,108638745,159691085,2001,12,68.1,64691085
16,2010-05-27,Sex and the City 2,95000000,95347692,294680778,2010,5,210.19,199680778
17,2010-02-12,Percy Jackson & the Olympians: The Lightning Thief,95000000,88768303,223050874,2010,2,134.79,128050874
18,2012-08-10,The Campaign,95000000,86907746,104907746,2012,8,10.43,9907746
19,2010-11-12,Unstoppable,95000000,81562942,165720921,2010,11,74.44,70720921
21,2000-03-31,The Road to El Dorado,95000000,50802661,65700000,2000,3,-30.84,-29300000
22,2009-12-11,The Lovely Bones,95000000,44114232,94894448,2009,12,-0.11,-105552
23,2016-08-19,Ben-Hur,95000000,26410477,91669648,2016,8,-3.51,-3330352
24,2015-02-06,Seventh Son,95000000,17725785,108874967,2015,2,14.61,13874967
25,2003-05-30,Finding Nemo,94000000,380529370,936429370,2003,5,896.2,842429370
26,2003-12-17,The Lord of the Rings: The Return of the King,94000000,377845905,1141403341,2003,12,1114.26,1047403341
27,2002-12-18,The Lord of the Rings: The Two Towers,94000000,342548984,934699645,2002,12,894.36,840699645
28,2001-06-15,Lara Croft: Tomb Raider,94000000,131144183,273330185,2001,6,190.78,179330185
29,2015-02-13,Kingsman: The Secret Service,94000000,128261724,404561724,2015,2,330.38,310561724
30,2001-07-18,Jurassic Park III,93000000,181166115,365900000,2001,7,293.44,272900000
31,2011-08-05,Rise of the Planet of the Apes,93000000,176760185,470986200,2011,8,406.44,377986200
32,2008-02-14,The Spiderwick Chronicles,92500000,71195053,162839667,2008,2,76.04,70339667
33,2004-11-05,The Incredibles,92000000,261441092,614726752,2004,11,568.18,522726752
34,2013-02-14,A Good Day to Die Hard,92000000,67349198,304249198,2013,2,230.71,212249198
35,2004-04-09,The Alamo,92000000,22406362,23911362,2004,4,-74.01,-68088638
37,2013-12-25,The Secret Life of Walter Mitty,91000000,58236838,187861183,2013,12,106.44,96861183
38,2017-12-20,Jumanji: Welcome to the Jungle,90000000,404508916,964496193,2017,12,971.66,874496193
41,2001-08-03,Rush Hour 2,90000000,226164286,347425832,2001,8,286.03,257425832
42,2009-12-25,Sherlock Holmes,90000000,209028679,498438212,2009,12,453.82,408438212
43,2009-07-01,Ice Age: Dawn of the Dinosaurs,90000000,196573705,859701857,2009,7,855.22,769701857
44,2018-12-14,Spider-Man: Into The Spider-Verse 3D,90000000,190173195,375381768,2018,12,317.09,285381768
45,2000-07-21,What Lies Beneath,90000000,155464351,288693989,2000,7,220.77,198693989
46,2011-04-15,Rio,90000000,143619809,487519809,2011,4,441.69,397519809
47,2006-10-06,The Departed,90000000,132384315,289660619,2006,10,221.85,199660619
48,2000-11-03,Charlie's Angels,90000000,125305545,259736090,2000,11,188.6,169736090
50,2008-08-13,Tropic Thunder,90000000,110515313,191145256,2008,8,112.38,101145256
51,2011-12-20,The Girl with the Dragon Tattoo,90000000,102515793,239373970,2011,12,165.97,149373970
53,2008-06-06,You Don't Mess With the Zohan,90000000,100018837,202910991,2008,6,125.46,112910991
55,2016-09-23,The Magnificent Seven,90000000,93432655,162525156,2016,9,80.58,72525156
56,2015-12-18,Alvin and the Chipmunks: The Road Chip,90000000,85886987,249517956,2015,12,177.24,159517956
57,2001-06-08,Atlantis: The Lost Empire,90000000,84052762,186049020,2001,6,106.72,96049020
58,2008-12-25,Valkyrie,90000000,83107829,203932174,2008,12,126.59,113932174
59,2015-07-24,Pixels,90000000,78765986,244041804,2015,7,171.16,154041804
60,2001-06-29,Artificial Intelligence: AI,90000000,78616689,235900000,2001,6,162.11,145900000
61,2003-11-26,The Haunted Mansion,90000000,75817994,155750628,2003,11,73.06,65750628
62,2000-08-04,Hollow Man,90000000,73209340,191200000,2000,8,112.44,101200000
63,2005-04-22,The Interpreter,90000000,72708161,162753837,2005,4,80.84,72753837
64,2013-08-07,Percy Jackson: Sea of Monsters,90000000,68559554,200859554,2013,8,123.18,110859554
65,2003-07-25,Lara Croft: Tomb Raider: The Cradle of Life,90000000,65653758,157092943,2003,7,74.55,67092943
66,2016-06-10,Now You See Me 2,90000000,65075540,328325007,2016,6,264.81,238325007
67,2001-11-21,Spy Game,90000000,62362560,143049560,2001,11,58.94,53049560
69,2000-03-10,Mission to Mars,90000000,60874615,106000000,2000,3,17.78,16000000
70,2018-03-16,Tomb Raider,90000000,58250803,273477501,2018,3,203.86,183477501
72,2004-07-07,King Arthur,90000000,51877963,203877963,2004,7,126.53,113877963
75,2002-07-19,K-19: The Widowmaker,90000000,35168966,65716126,2002,7,-26.98,-24283874
76,2011-08-19,Conan the Barbarian,90000000,21295021,63356133,2011,8,-29.6,-26643867
77,2011-10-21,The Three Musketeers,90000000,20377913,139877913,2011,10,55.42,49877913
78,2017-04-21,The Promise,90000000,8224288,10551417,2017,4,-88.28,-79448583
79,2010-11-24,The Nutcracker in 3D,90000000,195459,20466016,2010,11,-77.26,-69533984
83,2005-06-03,Cinderella Man,88000000,61649911,105021488,2005,6,19.34,17021488
84,2018-09-14,The Predator,88000000,51024708,159487563,2018,9,81.24,71487563
85,2005-07-08,Fantastic Four,87500000,154696080,333132750,2005,7,280.72,245632750
86,2001-02-09,Hannibal,87000000,165092266,350100280,2001,2,302.41,263100280
87,2003-07-25,Seabiscuit,86000000,120277854,148715342,2003,7,72.92,62715342
88,2000-12-22,Cast Away,85000000,233632142,427230516,2000,12,402.62,342230516
89,2006-11-17,Happy Feet,85000000,198000317,385000317,2006,11,352.94,300000317
90,2001-12-07,Ocean's Eleven,85000000,183417150,450728529,2001,12,430.27,365728529
91,2004-07-23,The Bourne Supremacy,85000000,176087450,311001124,2004,7,265.88,226001124
93,2009-04-03,Fast & Furious,85000000,155064265,363064265,2009,4,327.13,278064265
94,2008-03-14,Horton Hears a Who,85000000,154529439,299477886,2008,3,252.33,214477886
95,2014-03-21,Divergent,85000000,150947895,276014965,2014,3,224.72,191014965
96,2012-09-28,Hotel Transylvania,85000000,148313048,378505812,2012,9,345.3,293505812
97,2019-04-05,Shazam!,85000000,139606856,362899733,2019,4,326.94,277899733
98,2007-11-21,Enchanted,85000000,127706877,340384141,2007,11,300.45,255384141
99,2012-02-10,Safe House,85000000,126181630,208542162,2012,2,145.34,123542162
100,2007-07-20,I Now Pronounce You Chuck and Larry,85000000,119725280,185708462,2007,7,118.48,100708462
1,2007-06-08,Ocean's Thirteen,85000000,117144465,311744465,2007,6,266.76,226744465
2,2009-12-25,Itâs Complicated,85000000,112735375,224614744,2009,12,164.25,139614744
4,2006-09-29,Open Season,85000000,85105259,191932158,2006,9,125.8,106932158
5,2011-11-04,Tower Heist,85000000,78046570,150422946,2011,11,76.97,65422946
6,2000-11-22,102 Dalmatians,85000000,66941559,66941559,2000,11,-21.25,-18058441
7,2012-03-30,Mirror Mirror,85000000,64935167,173613482,2012,3,104.25,88613482
8,2006-12-08,The Holiday,85000000,63280000,205190324,2006,12,141.4,120190324
9,2006-06-16,The Fast and the Furious: Tokyo Drift,85000000,62615510,157794205,2006,6,85.64,72794205
10,2005-12-09,Memoirs of a Geisha,85000000,57010853,161510853,2005,12,90.01,76510853
11,2001-03-16,Enemy at the Gates,85000000,51396781,96971293,2001,3,14.08,11971293
13,2003-09-26,The Rundown,85000000,47641743,80831893,2003,9,-4.9,-4168107
14,2011-11-23,Arthur Christmas,85000000,46462469,149717124,2011,11,76.14,64717124
15,2017-01-20,xXx: Return of Xander Cage,85000000,44898413,345033359,2017,1,305.92,260033359
17,2010-07-30,Cats & Dogs: The Revenge of Kitty Galore,85000000,43585753,113026383,2010,7,32.97,28026383
18,2002-02-08,Collateral Damage,85000000,40048332,78353508,2002,2,-7.82,-6646492
19,2002-03-15,Showtime,85000000,37948765,78948765,2002,3,-7.12,-6051235
21,2007-03-02,Zodiac,85000000,33080084,83080084,2007,3,-2.26,-1919916
22,2010-08-13,Scott Pilgrim vs. The World,85000000,31611316,48056764,2010,8,-43.46,-36943236
23,2003-03-28,The Core,85000000,31111260,74132631,2003,3,-12.79,-10867369
25,2017-12-20,The Greatest Showman,84000000,174340174,386665550,2017,12,360.32,302665550
26,2002-06-14,Scooby-Doo,84000000,153294164,276294164,2002,6,228.92,192294164
27,2000-07-28,Nutty Professor II: The Klumps,84000000,123307945,166307945,2000,7,97.99,82307945
28,2013-07-19,RED 2,84000000,53262560,141507355,2013,7,68.46,57507355
29,2006-06-23,Click,82500000,137355633,237685089,2006,6,188.1,155185089
30,2006-12-15,Charlotte's Web,82500000,82985708,143985708,2006,12,74.53,61485708
31,2008-02-14,Jumper,82500000,80172128,222640812,2008,2,169.87,140140812
32,2008-07-11,Hellboy II: The Golden Army,82500000,75986503,160388063,2008,7,94.41,77888063
33,2005-05-27,The Longest Yard,82000000,158119460,191558505,2005,5,133.61,109558505
34,2010-08-13,The Expendables,82000000,103068524,268268174,2010,8,227.16,186268174
35,2000-11-17,The 6th Day,82000000,34543701,96024898,2000,11,17.1,14024898
37,2003-05-23,Bruce Almighty,81000000,242704995,484468608,2003,5,498.11,403468608
38,2012-03-23,The Hunger Games,80000000,408010692,677923379,2012,3,747.4,597923379
39,2011-05-26,The Hangover Part II,80000000,254464305,586464305,2011,5,633.08,506464305
41,2017-02-10,The Lego Batman Movie,80000000,175750384,310660018,2017,2,288.33,230660018
42,2015-09-25,Hotel Transylvania 2,80000000,169700110,469500298,2015,9,486.88,389500298
45,2006-05-19,Over the Hedge,80000000,155019340,343397247,2006,5,329.25,263397247
46,2002-06-21,Lilo & Stitch,80000000,145771527,245800000,2002,6,207.25,165800000
48,2013-07-12,Grown Ups 2,80000000,133668525,247023808,2013,7,208.78,167023808
49,2011-12-16,Alvin and the Chipmunks: Chipwrecked,80000000,133107389,349088523,2011,12,336.36,269088523
50,2008-06-20,Get Smart,80000000,130319208,226739416,2008,6,183.42,146739416
51,2005-03-11,Robots,80000000,128200012,260700012,2005,3,225.88,180700012
52,2010-02-19,Shutter Island,80000000,128012934,299461782,2010,2,274.33,219461782
53,2003-12-12,Something's Gotta Give,80000000,124685242,266685242,2003,12,233.36,186685242
54,2008-11-26,Four Christmases,80000000,120146040,168311558,2008,11,110.39,88311558
56,2008-12-25,Bedtime Stories,80000000,110101975,221468935,2008,12,176.84,141468935
57,2002-07-12,Road to Perdition,80000000,104054514,183354514,2002,7,129.19,103354514
58,2011-02-11,Just Go With It,80000000,103028109,214974953,2011,2,168.72,134974953
59,2003-02-14,Daredevil,80000000,102543518,182782518,2003,2,128.48,102782518
60,2008-09-26,Eagle Eye,80000000,101440743,180585259,2008,9,125.73,100585259
62,2010-12-17,Yogi Bear,80000000,100246011,204774690,2010,12,155.97,124774690
63,2003-12-25,Cold Mountain,80000000,95632614,165173909,2003,12,106.47,85173909
64,2010-01-15,The Book of Eli,80000000,94835059,158750817,2010,1,98.44,78750817
68,2014-10-17,Fury,80000000,85817906,210315681,2014,10,162.89,130315681
69,2018-09-28,Smallfoot,80000000,83240103,213691277,2018,9,167.11,133691277
70,2006-02-10,The Pink Panther,80000000,82226474,158926474,2006,2,98.66,78926474
71,2011-07-08,Zookeeper,80000000,80360866,170805525,2011,7,113.51,90805525
72,2008-12-12,The Day the Earth Stood Still,80000000,79366978,237370350,2008,12,196.71,157370350
75,2002-05-24,Spirit: Stallion of the Cimarron,80000000,73215310,106515310,2002,5,33.14,26515310
76,2001-06-08,Swordfish,80000000,69772969,147080413,2001,6,83.85,67080413
79,2004-07-30,The Manchurian Candidate,80000000,65948711,96148711,2004,7,20.19,16148711
80,2006-11-22,DÃ©jÃ Vu,80000000,64038616,181038616,2006,11,126.3,101038616
81,2019-06-07,The Secret Life of Pets 2,80000000,63795655,113351496,2019,6,41.69,33351496
82,2005-06-24,Bewitched,80000000,63313159,131159306,2005,6,63.95,51159306
83,2002-03-08,The Time Machine,80000000,56684819,98983590,2002,3,23.73,18983590
86,2005-10-28,The Legend of Zorro,80000000,45575336,141475336,2005,10,76.84,61475336
87,2000-11-10,Little Nicky,80000000,39442871,58270391,2000,11,-27.16,-21729609
88,2009-09-25,Surrogates,80000000,38577772,119668350,2009,9,49.59,39668350
89,2001-06-08,Evolution,80000000,38311134,98341932,2001,6,22.93,18341932
90,2005-08-26,The Brothers Grimm,80000000,37899638,105299638,2005,8,31.62,25299638
92,2006-04-14,The Wild,80000000,37384046,99010667,2006,4,23.76,19010667
93,2013-12-20,Walking with Dinosaurs,80000000,36076121,123368842,2013,12,54.21,43368842
94,2000-12-22,Thirteen Days,80000000,34566746,66554547,2000,12,-16.81,-13445453
96,2015-10-23,The Last Witch Hunter,80000000,27367660,130818912,2015,10,63.52,50818912
97,2014-02-21,Pompeii,80000000,23169033,108469033,2014,2,35.59,28469033
98,2000-05-12,Battlefield Earth: A Saga of the Year 3000,80000000,21471685,29725663,2000,5,-62.84,-50274337
99,2003-11-14,Looney Tunes: Back in Action,80000000,20950820,54540662,2003,11,-31.82,-25459338
100,2009-12-18,Nine,80000000,19676965,53508858,2009,12,-33.11,-26491142
1,2003-11-26,Timeline,80000000,19480739,26703184,2003,11,-66.62,-53296816
2,2010-04-22,Oceans,80000000,19422319,86787530,2010,4,8.48,6787530
5,2000-11-10,Red Planet,80000000,17480890,33463969,2000,11,-58.17,-46536031
6,2007-01-12,Arthur et les Minimoys,80000000,15132763,113325743,2007,1,41.66,33325743
7,2007-08-17,The Invasion,80000000,15074191,40147042,2007,8,-49.82,-39852958
8,2005-09-02,A Sound of Thunder,80000000,1900451,6300451,2005,9,-92.12,-73699549
10,2012-02-10,Journey 2: The Mysterious Island,79000000,103860290,318146162,2012,2,302.72,239146162
11,2011-11-11,Jack and Jill,79000000,74158157,150519217,2011,11,90.53,71519217
12,2001-12-21,A Beautiful Mind,78000000,170708996,317668058,2001,12,307.27,239668058
13,2013-09-27,Cloudy with a Chance of Meatballs 2,78000000,119793567,274392649,2013,9,251.79,196392649
14,2002-10-04,Red Dragon,78000000,92955420,206455420,2002,10,164.69,128455420
15,2004-03-05,Hidalgo,78000000,67286731,108086731,2004,3,38.57,30086731
16,2003-07-11,The League of Extraordinary Gentlemen,78000000,66465204,179265204,2003,7,129.83,101265204
17,2004-08-20,Exorcist: The Beginning,78000000,41814863,43957541,2004,8,-43.64,-34042459
18,2012-12-31,AstÃ©rix et ObÃ©lix: Au service de Sa MajestÃ©,77600000,0,60680125,2012,12,-21.8,-16919875
19,2016-02-12,The Little Prince,77500000,1311213,102028919,2016,2,31.65,24528919
20,2019-01-22,Renegades,77500000,0,1521672,2019,1,-98.04,-75978328
21,2018-07-20,The Equalizer 2,77000000,102084362,190453132,2018,7,147.34,113453132
22,2013-07-03,Despicable Me 2,76000000,368065385,975216835,2013,7,1183.18,899216835
23,2003-06-06,2 Fast 2 Furious,76000000,127120058,236410607,2003,6,211.07,160410607
24,2006-12-25,Children of Men,76000000,35552383,69845011,2006,12,-8.1,-6154989
25,2000-06-30,The Adventures of Rocky & Bullwinkle,76000000,26000610,35129610,2000,6,-53.78,-40870390
26,2016-07-08,The Secret Life of Pets,75000000,368384330,886750534,2016,7,1082.33,811750534
28,2018-11-09,Dr. Seussâ The Grinch,75000000,270620950,511002426,2018,11,581.34,436002426
29,2016-12-21,Sing,75000000,270329045,634454789,2016,12,745.94,559454789
30,2017-06-30,Despicable Me 3,75000000,264624300,1034727750,2017,6,1279.64,959727750
32,2006-03-31,Ice Age: The Meltdown,75000000,195330621,651899282,2006,3,769.2,576899282
33,2005-05-27,Madagascar,75000000,193595521,556559566,2005,5,642.08,481559566
34,2010-06-25,Grown Ups,75000000,162001186,272223430,2010,6,262.96,197223430
35,2004-10-01,Shark Tale,75000000,161412000,371917043,2004,10,395.89,296917043
36,2000-07-14,X-Men,75000000,157299717,296872367,2000,7,295.83,221872367
37,2008-06-27,Wanted,75000000,134508551,342416460,2008,6,356.56,267416460
39,2004-02-13,50 First Dates,75000000,120776832,196320329,2004,2,161.76,121320329
40,2007-07-20,Hairspray,75000000,118871849,203035572,2007,7,170.71,128035572
41,2013-05-31,Now You See Me,75000000,117723989,342769200,2013,5,357.03,267769200
42,2006-12-15,Dreamgirls,75000000,103365956,155708695,2006,12,107.61,80708695
43,2018-08-03,Christopher Robin,75000000,99215042,197504758,2018,8,163.34,122504758
45,2011-11-11,Immortals,75000000,83504017,211562435,2011,11,182.08,136562435
46,2004-06-18,The Terminal,75000000,77073959,218673959,2004,6,191.57,143673959
47,2005-02-18,Constantine,75000000,75976178,221594911,2005,2,195.46,146594911
48,2006-07-21,Monster House,75000000,73661010,141267370,2006,7,88.36,66267370
49,2000-12-08,Vertical Limit,75000000,68473360,213500000,2000,12,184.67,138500000
50,2007-12-21,Charlie Wilson's War,75000000,66661095,119512771,2007,12,59.35,44512771
52,2005-03-04,Be Cool,75000000,55849401,94944017,2005,3,26.59,19944017
53,2005-12-23,Munich,75000000,47379090,131492772,2005,12,75.32,56492772
54,2010-06-04,Killers,75000000,47059963,95572749,2010,6,27.43,20572749
55,2015-08-14,The Man From U.N.C.L.E.,75000000,45445109,104949584,2015,8,39.93,29949584
56,2003-03-07,Tears of the Sun,75000000,43632458,85632458,2003,3,14.18,10632458
57,2006-07-21,Lady in the Water,75000000,42285169,72785169,2006,7,-2.95,-2214831
58,2004-12-17,Spanglish,75000000,42044321,54344321,2004,12,-27.54,-20655679
59,2001-10-12,Bandits,75000000,41523271,71523271,2001,10,-4.64,-3476729
62,2011-03-25,Sucker Punch,75000000,36392502,89758389,2011,3,19.68,14758389
63,2005-03-11,Hostage,75000000,34636443,77636443,2005,3,3.52,2636443
64,2016-10-28,Inferno,75000000,34343574,219519367,2016,10,192.69,144519367
65,2003-06-13,Hollywood Homicide,75000000,30207785,50409753,2003,6,-32.79,-24590247
66,2000-06-16,Titan A.E.,75000000,22751979,36751979,2000,6,-51.0,-38248021
67,2004-12-17,Flight of the Phoenix,75000000,21009180,34009180,2004,12,-54.65,-40990820
70,2001-02-23,Monkeybone,75000000,5409517,5409517,2001,2,-92.79,-69590483
73,2015-07-10,Minions,74000000,336045770,1160336173,2015,7,1468.02,1086336173
74,2015-02-06,The SpongeBob Movie: Sponge Out of Water,74000000,162994032,311013181,2015,2,320.29,237013181
75,2000-11-22,Unbreakable,73243106,94999143,248099143,2000,11,238.73,174856037
76,2006-08-04,Talladega Nights: The Ballad of Ricky Bobby,73000000,148213377,162870525,2006,8,123.11,89870525
77,2016-05-20,The Angry Birds Movie,73000000,107509366,352327887,2016,5,382.64,279327887
80,2007-07-27,The Simpsons Movie,72500000,183135014,527071022,2007,7,626.99,454571022
81,2008-02-08,Fool's Gold,72500000,70231041,109362966,2008,2,50.85,36862966
82,2009-07-31,Funny People,72500000,51855045,71880305,2009,7,-0.85,-619695
83,2007-09-28,The Kingdom,72500000,47467250,86509602,2007,9,19.32,14009602
84,2001-06-22,Dr. Dolittle 2,72000000,112950721,176101721,2001,6,144.59,104101721
86,2005-11-04,Jarhead,72000000,62647540,96947540,2005,11,34.65,24947540
87,2001-04-27,Driven,72000000,32616869,54616869,2001,4,-24.14,-17383131
88,2001-12-21,The Majestic,72000000,27796042,37306334,2001,12,-48.19,-34693666
89,2004-06-25,Two Brothers,72000000,19176754,62176754,2004,6,-13.64,-9823246
90,2004-07-30,The Village,71682975,114197520,257641634,2004,7,259.42,185958659
92,2002-08-02,Signs,70702619,227969295,408269295,2002,8,477.45,337566676
93,2004-05-19,Shrek 2,70000000,441226247,937008132,2004,5,1238.58,867008132
94,2006-06-09,Cars,70000000,244082982,461651246,2006,6,559.5,391651246
95,2009-12-23,Alvin and the Chipmunks: The Squeakquel,70000000,219614612,443483213,2009,12,533.55,373483213
98,2002-08-09,xXx,70000000,141930000,267200000,2002,8,281.71,197200000
99,2018-06-08,Oceanâs 8,70000000,140218711,297115976,2018,6,324.45,227115976
1,2009-08-21,Inglourious Basterds,70000000,120774594,316915264,2009,8,352.74,246915264
4,2003-08-08,S.W.A.T.,70000000,116877597,207154748,2003,8,195.94,137154748
5,2017-11-10,Daddyâs Home 2,70000000,104029443,175807183,2017,11,151.15,105807183
7,2001-12-14,Vanilla Sky,70000000,100614858,202726605,2001,12,189.61,132726605
9,2013-03-22,Olympus Has Fallen,70000000,98927592,172878928,2013,3,146.97,102878928
10,2011-03-11,Battle: Los Angeles,70000000,83552429,213463976,2011,3,204.95,143463976
11,2004-08-13,AVP: Alien Vs. Predator,70000000,80281096,172543519,2004,8,146.49,102543519
12,2011-12-25,War Horse,70000000,79883359,156815529,2011,12,124.02,86815529
13,2002-03-01,We Were Soldiers,70000000,78120196,114658262,2002,3,63.8,44658262
14,2014-02-07,The Monuments Men,70000000,78031620,158702748,2014,2,126.72,88702748
15,2016-09-23,Storks,70000000,72679278,183353431,2016,9,161.93,113353431
17,2003-12-10,Big Fish,70000000,66432867,123954323,2003,12,77.08,53954323
19,2012-01-20,Underworld: Awakening,70000000,62321039,160379930,2012,1,129.11,90379930
20,2017-09-22,The Lego Ninjago Movie,70000000,59281555,122737201,2017,9,75.34,52737201
21,2014-10-10,Dracula Untold,70000000,55991880,220241723,2014,10,214.63,150241723
22,2006-09-29,The Guardian,70000000,55011732,94973540,2006,9,35.68,24973540
24,2010-09-24,Wall Street 2: Money Never Sleeps,70000000,52474616,137431619,2010,9,96.33,67431619
25,2011-01-14,The Dilemma,70000000,48475290,70546865,2011,1,0.78,546865
26,2005-12-25,Rumor Has It,70000000,42996140,88933562,2005,12,27.05,18933562
28,2007-08-10,Stardust,70000000,38634938,137022245,2007,8,95.75,67022245
29,2012-06-15,Rock of Ages,70000000,38518613,61031932,2012,6,-12.81,-8968068
31,2004-09-17,Sky Captain and the World of Tomorrow,70000000,37760080,49730854,2004,9,-28.96,-20269146
32,2007-09-14,The Brave One,70000000,36793804,69792704,2007,9,-0.3,-207296
33,2002-11-01,I Spy,70000000,33561137,60279822,2002,11,-13.89,-9720178
34,2002-06-07,Bad Company,70000000,30157016,69157016,2002,6,-1.2,-842984
35,2005-10-21,Doom,70000000,28212337,58757178,2005,10,-16.06,-11242822
36,2016-01-29,The Finest Hours,70000000,27569558,49252761,2016,1,-29.64,-20747239
37,2013-10-18,Escape Plan,70000000,25135965,103735965,2013,10,48.19,33735965
38,2011-09-23,Killer Elite,70000000,25124986,65409046,2011,9,-6.56,-4590954
40,2002-02-15,Hart's War,70000000,19076815,33076815,2002,2,-52.75,-36923185
41,2002-02-08,Rollerball,70000000,18990542,25852508,2002,2,-63.07,-44147492
42,2014-01-10,The Legend of Hercules,70000000,18848538,58953319,2014,1,-15.78,-11046681
43,2007-04-27,Next,70000000,18211013,73591500,2007,4,5.13,3591500
44,2002-09-20,Ballistic: Ecks vs. Sever,70000000,14294842,14294842,2002,9,-79.58,-55705158
45,2001-08-10,Osmosis Jones,70000000,13596911,13596911,2001,8,-80.58,-56403089
46,2014-05-09,Legends of Oz: Dorothyâs Return,70000000,8462347,20107933,2014,5,-71.27,-49892067
47,2015-01-16,Blackhat,70000000,8005980,19665004,2015,1,-71.91,-50334996
48,2006-03-31,Basic Instinct 2,70000000,5946136,35417162,2006,3,-49.4,-34582838
49,2010-05-28,Agora,70000000,619423,38992292,2010,5,-44.3,-31007708
50,2010-07-09,Despicable Me,69000000,251513985,543464573,2010,7,687.63,474464573
51,2010-07-30,Dinner for Schmucks,69000000,73026337,86796502,2010,7,25.79,17796502
52,2018-03-02,Red Sparrow,69000000,46874505,145951861,2018,3,111.52,76951861
53,2010-06-30,The Twilight Saga: Eclipse,68000000,300531751,706102828,2010,6,938.39,638102828
54,2002-05-31,The Sum of All Fears,68000000,118471320,193500000,2002,5,184.56,125500000
55,2015-06-26,Ted 2,68000000,81476385,217214143,2015,6,219.43,149214143
56,2001-07-13,The Score,68000000,71069884,113542091,2001,7,66.97,45542091
57,2011-02-25,Hall Pass,68000000,45060734,87173475,2011,2,28.2,19173475
59,2003-03-21,Dreamcatcher,68000000,33685268,75685268,2003,3,11.3,7685268
62,2017-12-22,Downsizing,68000000,24449754,54462971,2017,12,-19.91,-13537029
63,2012-03-02,Doctor Seuss' The Lorax,67500000,214030500,350976753,2012,3,419.97,283476753
64,2008-10-10,Body of Lies,67500000,39394666,118556530,2008,10,75.64,51056530
65,2012-06-22,Abraham Lincoln: Vampire Hunter,67500000,37519139,137489730,2012,6,103.69,69989730
67,2007-08-17,The Last Legion,67000000,5932060,25357771,2007,8,-62.15,-41642229
70,2014-03-14,Need for Speed,66000000,43568507,194169619,2014,3,194.2,128169619
72,2000-12-15,What Women Want,65000000,182805123,374105123,2000,12,475.55,309105123
73,2012-11-09,Lincoln,65000000,182207973,273346281,2012,11,320.53,208346281
74,2002-03-15,Ice Age,65000000,176387405,386116343,2002,3,494.03,321116343
77,2018-07-13,Hotel Transylvania 3: Summer Vacation,65000000,167500092,527079962,2018,7,710.89,462079962
78,2012-12-25,Les Miserables,65000000,148809770,442169052,2012,12,580.26,377169052
79,2002-11-01,The Santa Clause 2,65000000,139225854,172825854,2002,11,165.89,107825854
82,2014-12-25,Unbroken,65000000,115637895,163527824,2014,12,151.58,98527824
83,2015-06-05,Spy!,65000000,110825712,232585748,2015,6,257.82,167585748
84,2010-11-05,Due Date,65000000,100539043,211739043,2010,11,225.75,146739043
85,2008-07-25,Step Brothers,65000000,100468793,128468793,2008,7,97.64,63468793
88,2000-08-04,Space Cowboys,65000000,90454043,128874043,2000,8,98.27,63874043
89,2014-12-19,Annie,65000000,85911262,139829625,2014,12,115.12,74829625
91,2016-08-12,Peteâs Dragon,65000000,76233151,137768975,2016,8,111.95,72768975
93,2006-08-09,World Trade Center,65000000,70278893,163295654,2006,8,151.22,98295654
94,2000-07-07,The Kid,65000000,69688384,69688384,2000,7,7.21,4688384
95,2003-12-19,Mona Lisa Smile,65000000,63803100,141205169,2003,12,117.24,76205169
96,2012-05-16,The Dictator,65000000,59650222,180148897,2012,5,177.15,115148897
98,2012-02-17,This Means War,65000000,54760791,156974557,2012,2,141.5,91974557
99,2015-02-27,Focus,65000000,53862963,168065700,2015,2,158.56,103065700
100,2004-12-08,Blade: Trinity,65000000,52397389,131353165,2004,12,102.08,66353165
1,2012-11-21,Red Dawn,65000000,44806783,48164150,2012,11,-25.9,-16835850
2,2006-12-22,We Are Marshall,65000000,43545364,43545364,2006,12,-33.01,-21454636
3,2015-09-18,Everest,65000000,43482270,221297061,2015,9,240.46,156297061
4,2012-09-14,Resident Evil: Retribution,65000000,42345531,240647629,2012,9,270.23,175647629
7,2008-08-22,Death Race,65000000,36316032,72516819,2008,8,11.56,7516819
9,2000-12-08,Proof of Life,65000000,32598931,62761005,2000,12,-3.44,-2238995
10,2005-11-11,Zathura,65000000,28045540,58545540,2005,11,-9.93,-6454460
11,2003-11-26,The Missing,65000000,26900336,38253433,2003,11,-41.15,-26746567
12,2005-01-14,Elektra,65000000,24409722,56824633,2005,1,-12.58,-8175367
13,2009-10-23,Astro Boy,65000000,19551067,41636243,2009,10,-35.94,-23363757
14,2014-01-24,"I, Frankenstein",65000000,19075290,74575290,2014,1,14.73,9575290
16,2014-08-22,Sin City: A Dame to Kill For,65000000,13757804,40650842,2014,8,-37.46,-24349158
17,2016-12-25,Live by Night,65000000,10378555,21774432,2016,12,-66.5,-43225568
18,2000-10-27,Lucky Numbers,65000000,10014234,10014234,2000,10,-84.59,-54985766
19,2005-09-23,Oliver Twist,65000000,2070920,26670920,2005,9,-58.97,-38329080
20,2015-09-04,Tian jiang xiong shi,65000000,74070,122519874,2015,9,88.49,57519874
21,2018-10-26,Air Strike,65000000,0,516279,2018,10,-99.21,-64483721
22,2006-07-14,Little Man,64000000,58636047,101636047,2006,7,58.81,37636047
24,2006-12-27,Perfume: The Story of a Murderer,63700000,2223293,133603463,2006,12,109.74,69903463
26,2002-07-25,Austin Powers in Goldmember,63000000,213117789,296338663,2002,7,370.38,233338663
27,2011-04-01,Hop,63000000,108085305,188657593,2011,4,199.46,125657593
28,2017-09-15,American Assassin,63000000,36249674,68310140,2017,9,8.43,5310140
31,2000-04-21,U-571,62000000,77086030,127630030,2000,4,105.85,65630030
33,2015-12-25,The Hateful Eight,62000000,54117416,147864886,2015,12,138.49,85864886
34,2008-06-20,The Love Guru,62000000,32235793,40159017,2008,6,-35.23,-21840983
35,2001-02-23,3000 Miles to Graceland,62000000,15738632,18708848,2001,2,-69.82,-43291152
36,2014-10-03,Gone Girl,61000000,167767189,368567189,2014,10,504.21,307567189
37,2007-03-30,Blades of Glory,61000000,118594548,145594548,2007,3,138.68,84594548
38,2015-09-18,Maze Runner: The Scorch Trials,61000000,81697192,310566162,2015,9,409.12,249566162
39,2013-08-02,2 Guns,61000000,75612460,132493015,2013,8,117.2,71493015
40,2018-01-26,Maze Runner: The Death Cure,61000000,58032443,265878536,2018,1,335.87,204878536
41,2019-01-11,A Dogâs Way Home,61000000,41952715,81149689,2019,1,33.03,20149689
42,2016-02-19,Mei Ren Yu,60720000,3229457,554516671,2016,2,813.24,493796671
43,2004-12-22,Meet the Fockers,60000000,279167575,516567575,2004,12,760.95,456567575
44,2014-02-07,The Lego Movie,60000000,257784718,457729388,2014,2,662.88,397729388
45,2007-03-09,300,60000000,210614939,454161935,2007,3,656.94,394161935
46,2007-03-02,Wild Hogs,60000000,168213584,253555383,2007,3,322.59,193555383
47,2008-12-25,Marley & Me,60000000,143153751,247812011,2008,12,313.02,187812011
50,2016-09-09,Sully,60000000,125070033,238524556,2016,9,297.54,178524556
51,2002-06-14,The Bourne Identity,60000000,121468960,214357371,2002,6,257.26,154357371
52,2009-10-09,Couples Retreat,60000000,109205660,172450423,2009,10,187.42,112450423
54,2003-05-30,The Italian Job,60000000,106126012,176262839,2003,5,193.77,116262839
55,2003-05-09,Daddy Day Care,60000000,104148781,164285587,2003,5,173.81,104285587
58,2004-08-06,Collateral,60000000,100170152,217670152,2004,8,262.78,157670152
59,2001-07-04,Cats & Dogs,60000000,93375151,200700000,2001,7,234.5,140700000
60,2002-12-20,Two Weeks Notice,60000000,93354918,199043309,2002,12,231.74,139043309
62,2002-04-19,The Scorpion King,60000000,90580000,165890634,2002,4,176.48,105890634
63,2010-10-15,Red,60000000,90380162,196439693,2010,10,227.4,136439693
64,2004-03-05,Starsky & Hutch,60000000,88200225,170200225,2004,3,183.67,110200225
66,2005-12-21,Cheaper by the Dozen 2,60000000,82571173,135015330,2005,12,125.03,75015330
67,2010-08-13,Eat Pray Love,60000000,80574010,206598789,2010,8,244.33,146598789
68,2012-12-21,Jack Reacher,60000000,80070736,217370736,2012,12,262.28,157370736
69,2004-04-23,Man on Fire,60000000,77906816,130968579,2004,4,118.28,70968579
70,2000-12-22,The Family Man,60000000,75764085,124715863,2000,12,107.86,64715863
71,2011-09-09,Contagion,60000000,75658097,137551594,2011,9,129.25,77551594
74,2009-02-06,Coraline,60000000,75286229,126037057,2009,2,110.06,66037057
75,2004-10-01,Ladder 49,60000000,74541707,102332848,2004,10,70.55,42332848
77,2009-10-28,Michael Jackson's This Is It,60000000,72091016,252091016,2009,10,320.15,192091016
78,2003-01-17,Kangaroo Jack,60000000,66723216,90723216,2003,1,51.21,30723216
79,2008-06-13,The Happening,60000000,64506874,162778384,2008,6,171.3,102778384
80,2016-03-04,London Has Fallen,60000000,62524260,195194085,2016,3,225.32,135194085
81,2000-04-07,Rules of Engagement,60000000,61322858,71719931,2000,4,19.53,11719931
82,2006-03-10,The Shaggy Dog,60000000,61123569,87123569,2006,3,45.21,27123569
84,2004-04-02,Hellboy,60000000,59623958,99823958,2004,4,66.37,39823958
85,2016-10-21,Jack Reacher: Never Go Back,60000000,58697076,159946489,2016,10,166.58,99946489
86,2017-05-25,Baywatch,60000000,58060186,175863783,2017,5,193.11,115863783
88,2015-12-25,Joy,60000000,56451232,101134059,2015,12,68.56,41134059
89,2012-08-17,ParaNorman,60000000,56003051,108119662,2012,8,80.2,48119662
91,2003-12-25,Paycheck,60000000,53789313,98819789,2003,12,64.7,38819789
93,2008-12-19,The Tale of Despereaux,60000000,50877145,90482317,2008,12,50.8,30482317
94,2014-09-26,The Boxtrolls,60000000,50837305,111946251,2014,9,86.58,51946251
95,2017-08-04,The Dark Tower,60000000,50701325,113461527,2017,8,89.1,53461527
96,2002-09-27,The Tuxedo,60000000,50586000,104429625,2002,9,74.05,44429625
97,2014-01-17,Jack Ryan: Shadow Recruit,60000000,50577412,131377412,2014,1,118.96,71377412
99,2005-03-24,Miss Congeniality 2: Armed and Fabulous,60000000,48478006,101382396,2005,3,68.97,41382396
100,2018-12-25,Vice,60000000,47836282,70883171,2018,12,18.14,10883171
2,2007-03-23,Shooter,60000000,47003582,95538560,2007,3,59.23,35538560
4,2013-01-11,Gangster Squad,60000000,46000903,104100903,2013,1,73.5,44100903
5,2017-04-07,Smurfs: The Lost Village,60000000,45020282,197578586,2017,4,229.3,137578586
6,2018-10-12,First Man,60000000,44936545,105203825,2018,10,75.34,45203825
7,2009-06-19,Year One,60000000,43337279,57604723,2009,6,-3.99,-2395277
8,2010-01-29,Edge of Darkness,60000000,43313890,82812456,2010,1,38.02,22812456
9,2002-12-13,Star Trek: Nemesis,60000000,43254409,67312826,2002,12,12.19,7312826
10,2002-02-19,Reign of Fire,60000000,43061982,82150183,2002,2,36.92,22150183
11,2009-11-20,Planet 51,60000000,42194060,108996113,2009,11,81.66,48996113
12,2009-03-20,Duplicity,60000000,40572825,81079566,2009,3,35.13,21079566
13,2008-09-12,Righteous Kill,60000000,40081410,78481410,2008,9,30.8,18481410
14,2009-12-11,Invictus,60000000,37491364,124514011,2009,12,107.52,64514011
15,2009-04-17,State of Play,60000000,37017955,88832210,2009,4,48.05,28832210
17,2006-04-21,The Sentinel,60000000,36280697,78080697,2006,4,30.13,18080697
18,2012-09-21,Trouble with the Curve,60000000,35763137,47818913,2012,9,-20.3,-12181087
19,2003-10-10,Intolerable Cruelty,60000000,35327628,121327628,2003,10,102.21,61327628
22,2000-09-15,Almost Famous,60000000,32522352,47371191,2000,9,-21.05,-12628809
23,2019-02-08,Cold Pursuit,60000000,32138862,62599159,2019,2,4.33,2599159
24,2002-12-06,Analyze That,60000000,32122249,54994757,2002,12,-8.34,-5005243
25,2009-04-24,The Soloist,60000000,31853584,38522450,2009,4,-35.8,-21477550
26,2013-08-21,The Mortal Instruments: City of Bones,60000000,31165421,75965567,2013,8,26.61,15965567
27,2000-11-03,The Legend of Bagger Vance,60000000,30695227,39235486,2000,11,-34.61,-20764514
28,2002-02-22,Dragonfly,60000000,30063805,30063805,2002,2,-49.89,-29936195
29,2011-05-13,Priest,60000000,29136626,84154026,2011,5,40.26,24154026
30,2006-06-16,Garfield: A Tail of Two Kitties,60000000,28426747,147985373,2006,6,146.64,87985373
31,2005-04-29,XXX: State of the Union,60000000,26873932,71073932,2005,4,18.46,11073932
33,2003-07-02,Sinbad: Legend of the Seven Seas,60000000,26483452,80767884,2003,7,34.61,20767884
34,2005-07-08,Dark Water,60000000,25473093,49473093,2005,7,-17.54,-10526907
36,2006-09-15,The Black Dahlia,60000000,22672813,49238525,2006,9,-17.94,-10761475
38,2008-12-25,The Spirit,60000000,19806188,39006188,2008,12,-34.99,-20993812
39,2001-10-19,The Last Castle,60000000,18208078,20541668,2001,10,-65.76,-39458332
40,2009-01-23,Inkheart,60000000,17303424,66655938,2009,1,11.09,6655938
41,2000-01-14,Supernova,60000000,14218868,14816494,2000,1,-75.31,-45183506
42,2006-09-22,Flyboys,60000000,13090630,14816379,2006,9,-75.31,-45183621
43,2014-02-14,Winterâs Tale,60000000,12600231,29575033,2014,2,-50.71,-30424967
45,2008-07-11,Meet Dave,60000000,11803254,50648806,2008,7,-15.59,-9351194
46,2005-08-12,The Great Raid,60000000,10166502,10597070,2005,8,-82.34,-49402930
47,2017-02-24,Rock Dog,60000000,9420546,24148488,2017,2,-59.75,-35851512
48,2015-01-23,Mortdecai,60000000,7696134,30396134,2015,1,-49.34,-29603866
49,2008-01-11,In the Name of the King: A Dungeon Siege Tale,60000000,4775656,13233220,2008,1,-77.94,-46766780
50,2003-10-24,Beyond Borders,60000000,4426297,11427090,2003,10,-80.95,-48572910
51,2016-02-05,Xi You Ji zhi Sun Wu Kong San Da Bai Gu Jing,60000000,709982,194058503,2016,2,223.43,134058503
54,2018-03-23,Sherlock Gnomes,59000000,43242871,87527651,2018,3,48.35,28527651
55,2019-01-25,The Kid Who Would Be King,59000000,16790790,28348446,2019,1,-51.95,-30651554
56,2016-02-12,Deadpool,58000000,363070709,801025593,2016,2,1281.08,743025593
57,2014-12-25,American Sniper,58000000,350126372,547326372,2014,12,843.67,489326372
58,2015-10-16,Goosebumps,58000000,80069458,158905324,2015,10,173.97,100905324
61,2012-01-20,Red Tails,58000000,49876377,50365498,2012,1,-13.16,-7634502
62,2005-09-16,Just Like Heaven,58000000,48318130,100687083,2005,9,73.6,42687083
63,2013-06-07,The Internship,58000000,44672764,93672764,2013,6,61.5,35672764
64,2000-04-28,The Flintstones in Viva Rock Vegas,58000000,35231365,59431365,2000,4,2.47,1431365
65,2008-04-04,Leatherheads,58000000,31373938,41348628,2008,4,-28.71,-16651372
66,2017-03-24,Life,58000000,30234022,100929666,2017,3,74.02,42929666
67,2009-12-18,Did You Hear About the Morgans?,58000000,29580087,80480566,2009,12,38.76,22480566
68,2008-12-12,"Che, Part 1: The Argentine",58000000,1802521,31627370,2008,12,-45.47,-26372630
69,2008-05-30,Sex and the City,57500000,152647258,415247258,2008,5,622.17,357747258
70,2010-09-10,Resident Evil: Afterlife,57500000,60128566,295874190,2010,9,414.56,238374190
71,2012-06-15,That's My Boy,57500000,36931089,58085235,2012,6,1.02,585235
73,2012-02-17,Ghost Rider: Spirit of Vengeance,57000000,51774002,149217355,2012,2,161.78,92217355
75,2004-11-12,After the Sunset,57000000,28328132,38329114,2004,11,-32.76,-18670886
76,2001-08-17,Captain Corelli's Mandolin,57000000,25528495,62097495,2001,8,8.94,5097495
77,2014-12-25,Into the Woods,56200000,128002372,213116401,2014,12,279.21,156916401
78,2003-04-11,Anger Management,56000000,135560942,195660942,2003,4,249.39,139660942
79,2005-03-04,The Pacifier,56000000,113006880,198006880,2005,3,253.58,142006880
80,2004-04-02,Walking Tall,56000000,46213824,47313824,2004,4,-15.51,-8686176
81,2016-01-22,Zhuo yao ji,56000000,32766,359495591,2016,1,541.96,303495591
83,2007-12-14,Alvin and the Chipmunks,55000000,217326974,362605033,2007,12,559.28,307605033
84,2018-11-02,Bohemian Rhapsody,55000000,216303339,894985342,2018,11,1527.25,839985342
85,2005-02-11,Hitch,55000000,177784257,366784257,2005,2,566.88,311784257
86,2000-10-06,Meet the Parents,55000000,166225040,330425040,2000,10,500.77,275425040
87,2006-12-15,The Pursuit of Happyness,55000000,162586036,307311093,2006,12,458.75,252311093
91,2017-02-10,Fifty Shades Darker,55000000,114434010,381398492,2017,2,593.45,326398492
92,2013-10-11,Captain Phillips,55000000,107136417,220648184,2013,10,301.18,165648184
94,2003-08-01,American Wedding,55000000,104354205,126425115,2003,8,129.86,71425115
95,2017-11-10,Murder on the Orient Express,55000000,102826543,345922730,2017,11,528.95,290922730
96,2014-09-26,The Equalizer,55000000,101530738,192903624,2014,9,250.73,137903624
97,2018-02-09,Fifty Shades Freed,55000000,100407760,371350619,2018,2,575.18,316350619
99,2010-04-09,Date Night,55000000,98711404,152269033,2010,4,176.85,97269033
100,2002-12-13,Maid in Manhattan,55000000,93932896,163838217,2002,12,197.89,108838217
2,2005-09-23,Flightplan,55000000,89706988,214392904,2005,9,289.81,159392904
5,2015-01-16,Paddington,55000000,76223578,258789097,2015,1,370.53,203789097
6,2006-04-28,R.V.,55000000,71724497,87473024,2006,4,59.04,32473024
8,2003-10-10,Kill Bill: Volume 1,55000000,70098138,176469428,2003,10,220.85,121469428
9,2011-06-17,Mr. Poppers's Penguins,55000000,68224452,189624452,2011,6,244.77,134624452
11,2004-04-16,Kill Bill: Volume 2,55000000,66207920,153535982,2004,4,179.16,98535982
14,2000-05-26,Shanghai Noon,55000000,56932305,71189835,2000,5,29.44,16189835
16,2013-11-01,Free Birds,55000000,55750480,110387072,2013,11,100.7,55387072
18,2008-04-18,The Forbidden Kingdom,55000000,52075270,129075270,2008,4,134.68,74075270
19,2004-12-22,The Phantom of the Opera,55000000,51225796,153770052,2004,12,179.58,98770052
20,2014-03-21,Muppets Most Wanted,55000000,51178893,79312301,2014,3,44.2,24312301
22,2016-08-19,Kubo and the Two Strings,55000000,48023088,77548122,2016,8,41.0,22548122
24,2010-11-24,Burlesque,55000000,39440655,90552675,2010,11,64.64,35552675
26,2008-10-24,Changeling,55000000,35739802,113805580,2008,10,106.92,58805580
27,2012-07-27,The Watch,55000000,34353000,67130045,2012,7,22.05,12130045
28,2003-03-14,The Hunted,55000000,34234008,47213095,2003,3,-14.16,-7786905
30,2003-12-12,Stuck On You,55000000,33832741,63537164,2003,12,15.52,8537164
31,2008-02-29,Semi-Pro,55000000,33479698,43980363,2008,2,-20.04,-11019637
32,2018-02-23,Annihilation,55000000,32732301,43070915,2018,2,-21.69,-11929085
33,2015-10-16,Crimson Peak,55000000,31090320,74966854,2015,10,36.3,19966854
34,2012-04-27,The Pirates! Band of Misfits,55000000,31051126,136143605,2012,4,147.53,81143605
35,2005-12-02,Aeon Flux,55000000,25857987,53913573,2005,12,-1.98,-1086427
38,2007-10-12,Elizabeth: The Golden Age,55000000,16285240,74870866,2007,10,36.13,19870866
39,2009-06-12,Imagine That,55000000,16222392,22438144,2009,6,-59.2,-32561856
40,2003-02-21,Gods and Generals,55000000,12882934,12923936,2003,2,-76.5,-42076064
42,2013-02-01,Bullet to the Head,55000000,9489829,22597969,2013,2,-58.91,-32402031
43,2006-09-22,All the King's Men,55000000,7221458,9521458,2006,9,-82.69,-45478542
44,2004-07-30,Thunderbirds,55000000,6768055,28231444,2004,7,-48.67,-26768556
45,2004-11-26,Un long dimanche de fianÃ§ailles,55000000,6167817,69759296,2004,11,26.84,14759296
46,2007-05-04,Lucky You,55000000,5755286,6521829,2007,5,-88.14,-48478171
48,2002-09-20,Eye See You,55000000,79161,1807990,2002,9,-96.71,-53192010
50,2002-03-22,Blade 2,54000000,81676888,154338601,2002,3,185.81,100338601
51,2006-07-14,"You, Me and Dupree",54000000,75802010,130402010,2006,7,141.49,76402010
52,2008-12-19,Seven Pounds,54000000,69951824,166617328,2008,12,208.55,112617328
54,2005-10-14,Elizabethtown,54000000,26850426,50719373,2005,10,-6.08,-3280627
55,2003-08-01,Gigli,54000000,6087542,7126002,2003,8,-86.8,-46873998
56,2000-06-16,Shaft,53012938,70327868,107190108,2000,6,102.2,54177170
57,2005-08-05,The Dukes of Hazzard,53000000,80270227,109848461,2005,8,107.26,56848461
58,2009-10-16,Law Abiding Citizen,53000000,73357727,131159781,2009,10,147.47,78159781
59,2015-09-18,Black Mass,53000000,62575678,98837872,2015,9,86.49,45837872
61,2001-05-18,Moulin Rouge,53000000,57386369,179200588,2001,5,238.11,126200588
62,2001-11-02,Domestic Disturbance,53000000,45207112,54207112,2001,11,2.28,1207112
63,2006-10-20,Flags of Our Fathers,53000000,33602376,63657941,2006,10,20.11,10657941
64,2007-04-06,Grindhouse,53000000,25031037,50187789,2007,4,-5.31,-2812211
66,2012-12-19,Zero Dark Thirty,52500000,95720716,134612435,2012,12,156.4,82112435
67,2002-12-25,Catch Me if You Can,52000000,164606800,355612291,2002,12,583.87,303612291
68,2008-07-18,Mamma Mia!,52000000,144130063,615748772,2008,7,1084.13,563748772
69,2006-06-02,The Break-Up,52000000,118703275,205727307,2006,6,295.63,153727307
70,2010-02-12,Valentine's Day,52000000,110485654,217569328,2010,2,318.4,165569328
72,2011-08-05,The Change-Up,52000000,37243418,75997067,2011,8,46.15,23997067
75,2010-02-05,From Paris With Love,52000000,24077427,53139168,2010,2,2.19,1139168
76,2003-04-16,Bulletproof Monk,52000000,23010607,23010607,2003,4,-55.75,-28989393
77,2000-06-23,"Me, Myself & Irene",51000000,90570999,149270999,2000,6,192.69,98270999
78,2006-08-04,Barnyard: The Original Party Animals,51000000,72779000,118583844,2006,8,132.52,67583844
79,2018-08-17,Alpha,51000000,35851379,99624873,2018,8,95.34,48624873
80,2006-11-22,Deck the Halls,51000000,35093569,46815807,2006,11,-8.2,-4184193
81,2011-03-04,The Adjustment Bureau,50200000,62495645,126931325,2011,3,152.85,76731325
82,2009-11-20,The Twilight Saga: New Moon,50000000,296623634,687557727,2009,11,1275.12,637557727
83,2001-05-18,Shrek,50000000,267655011,491812794,2001,5,883.63,441812794
84,2012-06-29,Ted,50000000,218665740,556016627,2012,6,1012.03,506016627
85,2014-06-13,22 Jump Street,50000000,191719337,331333876,2014,6,562.67,281333876
88,2015-12-25,Daddyâs Home,50000000,150357137,242757137,2015,12,385.51,192757137
91,2016-06-17,Central Intelligence,50000000,127440871,217194805,2016,6,334.39,167194805
92,2013-12-18,Anchorman 2: The Legend Continues,50000000,127352707,172185754,2013,12,244.37,122185754
93,2011-06-10,Super 8,50000000,127004179,257972745,2011,6,415.95,207972745
94,2002-06-28,Mr. Deeds,50000000,126293452,171269535,2002,6,242.54,121269535
95,2000-03-17,Erin Brockovich,50000000,125548685,257805243,2000,3,415.61,207805243
96,2018-11-21,Creed II,50000000,115715889,213591522,2018,11,327.18,163591522
97,2018-02-09,Peter Rabbit,50000000,115234093,347136477,2018,2,594.27,297136477
98,2003-02-07,How to Lose a Guy in 10 Days,50000000,105807520,178890782,2003,2,257.78,128890782
100,2018-12-14,The Mule,50000000,103804407,170857676,2018,12,241.72,120857676
1,2008-12-19,Yes Man,50000000,97690976,225990976,2008,12,351.98,175990976
2,2014-02-28,Non-Stop,50000000,91742160,222383055,2014,2,344.77,172383055
4,2013-08-09,Disney Planes,50000000,90282580,238059569,2013,8,376.12,188059569
5,2006-03-10,Failure to Launch,50000000,88715192,128402901,2006,3,156.81,78402901
6,2006-03-24,Inside Man,50000000,88634237,185798265,2006,3,271.6,135798265
7,2017-07-28,The Emoji Movie,50000000,86089513,216562312,2017,7,333.12,166562312
8,2011-07-29,"Crazy, Stupid, Love",50000000,84351197,147142328,2011,7,194.28,97142328
9,2017-12-22,The Post,50000000,81903458,179748880,2017,12,259.5,129748880
12,2009-03-20,Knowing,50000000,79957634,186450317,2009,3,272.9,136450317
13,2005-03-18,The Ring Two,50000000,75941727,161941727,2005,3,223.88,111941727
14,2011-12-23,We Bought a Zoo,50000000,75624550,118729073,2011,12,137.46,68729073
15,2011-09-23,Moneyball,50000000,75605492,111300835,2011,9,122.6,61300835
16,2004-06-11,Garfield: The Movie,50000000,75367693,208094550,2004,6,316.19,158094550
17,2004-11-24,Christmas with the Kranks,50000000,73701902,96469187,2004,11,92.94,46469187
18,2006-03-17,V for Vendetta,50000000,70511035,130214162,2006,3,160.43,80214162
20,2009-03-13,Race to Witch Mountain,50000000,67172595,105103784,2009,3,110.21,55103784
21,2004-09-24,The Forgotten,50000000,66711892,117211892,2004,9,134.42,67211892
22,2005-06-22,Herbie: Fully Loaded,50000000,66010682,144110682,2005,6,188.22,94110682
23,2003-02-07,Shanghai Knights,50000000,60470220,88316835,2003,2,76.63,38316835
24,2014-07-18,Planes: Fire and Rescue,50000000,59157732,156399644,2014,7,212.8,106399644
25,2006-02-10,Curious George,50000000,58640119,71052604,2006,2,42.11,21052604
26,2012-04-06,American Reunion,50000000,56758835,236799211,2012,4,373.6,186799211
27,2013-01-25,Hansel & Gretel: Witch Hunters,50000000,55703475,214949716,2013,1,329.9,164949716
28,2011-02-18,I am Number Four,50000000,55100437,146195159,2011,2,192.39,96195159
29,2001-09-28,Donât Say a Word,50000000,54997476,104488383,2001,9,108.98,54488383
30,2016-01-15,13 Hours: The Secret Soldiers of Benghazi,50000000,52853219,69411370,2016,1,38.82,19411370
31,2002-05-08,Unfaithful,50000000,52752475,119114494,2002,5,138.23,69114494
32,2017-09-29,American Made,50000000,51342000,135569212,2017,9,171.14,85569212
33,2005-11-23,Syriana,50000000,50824620,92690959,2005,11,85.38,42690959
34,2004-09-10,Resident Evil: Apocalypse,50000000,50740078,125168734,2004,9,150.34,75168734
35,2014-10-17,The Book of Life,50000000,50151543,97651543,2014,10,95.3,47651543
37,2006-02-10,Firewall,50000000,48751189,82751189,2006,2,65.5,32751189
40,2014-08-08,Into the Storm,50000000,47602194,150429371,2014,8,200.86,100429371
41,2014-10-10,The Judge,50000000,47119388,76119388,2014,10,52.24,26119388
42,2006-04-21,Silent Hill,50000000,46982632,94704227,2006,4,89.41,44704227
43,2000-08-11,The Replacements,50000000,44737059,50054511,2000,8,0.11,54511
45,2016-08-19,War Dogs,50000000,43034523,86234503,2016,8,72.47,36234503
49,2003-10-03,Out of Time,50000000,41083108,55489826,2003,10,10.98,5489826
50,2004-11-12,Bridget Jones: The Edge Of Reason,50000000,40203020,263894551,2004,11,427.79,213894551
51,2000-02-11,The Beach,50000000,39778599,39778599,2000,2,-20.44,-10221401
52,2005-06-10,The Adventures of Sharkboy and Lavagirl in 3-D,50000000,39177684,69425966,2005,6,38.85,19425966
54,2009-11-25,Ninja Assassin,50000000,38122883,62209892,2009,11,24.42,12209892
55,2004-05-28,Raising Helen,50000000,37485528,49928680,2004,5,-0.14,-71320
56,2016-05-20,The Nice Guys,50000000,36261763,59596747,2016,5,19.19,9596747
59,2010-06-04,Marmaduke,50000000,33644788,89895930,2010,6,79.79,39895930
61,2010-10-15,Hereafter,50000000,32746941,108660270,2010,10,117.32,58660270
62,2002-04-19,Murder by Numbers,50000000,31874869,56643267,2002,4,13.29,6643267
64,2016-02-12,Zoolander 2,50000000,28848693,55348693,2016,2,10.7,5348693
65,2009-01-16,Defiance,50000000,28644813,52987754,2009,1,5.98,2987754
66,2007-02-09,Hannibal Rising,50000000,27669725,80583311,2007,2,61.17,30583311
68,2013-03-29,The Host,50000000,26623701,64477051,2013,3,28.95,14477051
69,2003-03-28,Basic,50000000,26599248,42598498,2003,3,-14.8,-7401502
70,2015-03-13,Run All Night,50000000,26461644,66961644,2015,3,33.92,16961644
71,2002-08-09,Blood Work,50000000,26199517,26199517,2002,8,-47.6,-23800483
72,2009-02-13,The International,50000000,25450527,53850527,2009,2,7.7,3850527
74,2004-02-27,Twisted,50000000,25195050,40119848,2004,2,-19.76,-9880152
75,2004-12-10,The Life Aquatic with Steve Zissou,50000000,24006726,34806726,2004,12,-30.39,-15193274
77,2019-04-12,Hellboy,50000000,21903748,40725492,2019,4,-18.55,-9274508
78,2011-04-08,Your Highness,50000000,21596445,26121638,2011,4,-47.76,-23878362
79,2016-09-16,Snowden,50000000,21587519,35380918,2016,9,-29.24,-14619082
80,2011-09-30,Dream House,50000000,21302340,41642166,2011,9,-16.72,-8357834
81,2016-06-24,Free State of Jones,50000000,20810036,23237252,2016,6,-53.53,-26762748
82,2009-09-04,Gamer,50000000,20534907,42002029,2009,9,-16.0,-7997971
83,2005-02-25,Man of the House,50000000,19699706,22099706,2005,2,-55.8,-27900294
84,2003-02-21,The Life of David Gale,50000000,19694635,28920188,2003,2,-42.16,-21079812
85,2013-02-14,Beautiful Creatures,50000000,19452138,60282876,2013,2,20.57,10282876
86,2005-09-30,Into the Blue,50000000,18782227,41982227,2005,9,-16.04,-8017773
87,2007-09-14,Eastern Promises,50000000,17181265,56077088,2007,9,12.15,6077088
91,2011-02-25,Drive Angry,50000000,10721033,41042583,2011,2,-17.91,-8957417
94,2005-10-14,Domino,50000000,10169202,23574057,2005,10,-52.85,-26425943
96,2009-02-27,Street Fighter: The Legend of Chun-Li,50000000,8742261,12660287,2009,2,-74.68,-37339713
97,2002-03-29,Death to Smoochy,50000000,8355815,8374062,2002,3,-83.25,-41625938
98,2018-02-16,Early Man,50000000,8267544,45285890,2018,2,-9.43,-4714110
99,2009-11-13,The Boat That Rocked,50000000,8017467,37472651,2009,11,-25.05,-12527349
100,2004-01-30,The Big Bounce,50000000,6471394,6626115,2004,1,-86.75,-43373885
1,2000-03-03,What Planet Are You From?,50000000,6291602,6291602,2000,3,-87.42,-43708398
2,2015-04-17,Child 44,50000000,1224330,8004221,2015,4,-83.99,-41995779
3,2009-01-23,Outlander,50000000,166003,1250617,2009,1,-97.5,-48749383
4,2013-03-15,Upside Down,50000000,102118,26387039,2013,3,-47.23,-23612961
5,2015-10-02,Shanghai,50000000,46425,15505922,2015,10,-68.99,-34494078
10,2001-11-02,The One,49000000,43905746,72689126,2001,11,48.35,23689126
11,2015-03-06,Chappie,49000000,31569268,105002056,2015,3,114.29,56002056
13,2012-11-16,Anna Karenina,49000000,12816367,71004627,2012,11,44.91,22004627
15,2002-10-18,The Ring,48000000,129094024,248218486,2002,10,417.12,200218486
16,2000-12-27,Traffic,48000000,124107476,208300000,2000,12,333.96,160300000
17,2002-03-29,Panic Room,48000000,95308367,196308367,2002,3,308.98,148308367
18,2015-01-09,Taken 3,48000000,89256424,327656424,2015,1,582.62,279656424
20,2018-11-16,Instant Family,48000000,67363237,119736188,2018,11,149.45,71736188
23,2010-01-22,Tooth Fairy,48000000,60022256,112610386,2010,1,134.6,64610386
24,2001-08-17,Rat Race,48000000,56607223,86607223,2001,8,80.43,38607223
25,2007-09-07,3:10 to Yuma,48000000,53606916,71171825,2007,9,48.27,23171825
26,2001-08-13,K-PAX,48000000,50315140,50315140,2001,8,4.82,2315140
27,2001-12-25,Kate and Leopold,48000000,47095453,70937778,2001,12,47.79,22937778
28,2000-10-20,Bedazzled,48000000,37879996,90376224,2000,10,88.28,42376224
31,2008-01-25,Rambo,47500000,42754105,112214531,2008,1,136.24,64714531
32,2016-07-13,The Infiltrator,47500000,15436808,20718104,2016,7,-56.38,-26781896
34,2016-11-11,Arrival,47000000,100546139,203127894,2016,11,332.19,156127894
36,2009-04-22,Earth,47000000,32011576,116773317,2009,4,148.45,69773317
37,2001-10-19,Riding in Cars with Boys,47000000,29781453,29781453,2001,10,-36.64,-17218547
38,2007-01-05,Happily N'Ever After,47000000,15849032,37923818,2007,1,-19.31,-9076182
39,2002-11-27,Solaris,47000000,14970038,14970038,2002,11,-68.15,-32029962
40,2010-06-18,Jonah Hex,47000000,10547117,11022696,2010,6,-76.55,-35977304
42,2016-12-23,Silence,46500000,7100177,23726626,2016,12,-48.97,-22773374
43,2013-11-01,Mr. Nobody,46500000,3622,22254,2013,11,-99.95,-46477746
45,2001-07-20,America's Sweethearts,46000000,93607673,160648493,2001,7,249.24,114648493
47,2002-05-24,Insomnia,46000000,67263182,113622499,2002,5,147.01,67622499
48,2013-09-20,Prisoners,46000000,61002302,113402302,2013,9,146.53,67402302
51,2010-12-31,Arthur and the War of Two Worlds,45500000,347136,36180824,2010,12,-20.48,-9319176
54,2012-10-05,Taken 2,45000000,139854287,377807404,2012,10,739.57,332807404
56,2003-10-24,Scary Movie 3,45000000,110000082,155200000,2003,10,244.89,110200000
57,2000-12-22,Miss Congeniality,45000000,106807667,213420951,2000,12,374.27,168420951
58,2017-12-22,Pitch Perfect 3,45000000,104897530,185736412,2017,12,312.75,140736412
59,2008-07-11,Journey to the Center of the Earth,45000000,101704370,243180937,2008,7,440.4,198180937
61,2004-08-11,The Princess Diaries 2: Royal Engagement,45000000,95149435,122071435,2004,8,171.27,77071435
62,2007-12-25,The Bucket List,45000000,93466502,174807445,2007,12,288.46,129807445
64,2011-11-23,The Muppets,45000000,88625922,160971922,2011,11,257.72,115971922
66,2005-05-13,Monster-in-Law,45000000,82931301,155931301,2005,5,246.51,110931301
67,2001-10-05,Training Day,45000000,76261036,104505362,2001,10,132.23,59505362
68,2016-10-07,The Girl on the Train,45000000,75395035,174278214,2016,10,287.28,129278214
70,2001-07-04,Scary Movie 2,45000000,71277420,141189101,2001,7,213.75,96189101
72,2005-01-14,Coach Carter,45000000,67264877,76665507,2005,1,70.37,31665507
73,2010-03-19,The Bounty Hunter,45000000,67061228,135808837,2010,3,201.8,90808837
74,2002-04-12,Changing Lanes,45000000,66790248,66790248,2002,4,48.42,21790248
76,2006-01-20,Underworld: Evolution,45000000,62318875,113417762,2006,1,152.04,68417762
77,2000-08-04,Coyote Ugly,45000000,60786269,113916474,2000,8,153.15,68916474
78,2003-11-07,Love Actually,45000000,59472278,248505300,2003,11,452.23,203505300
81,2016-12-09,Office Christmas Party,45000000,54767494,91323299,2016,12,102.94,46323299
83,2005-11-23,"Yours, Mine and Ours",45000000,53359917,72359917,2005,11,60.8,27359917
84,2005-05-13,Kicking and Screaming,45000000,52842724,55842724,2005,5,24.09,10842724
85,2005-04-29,The Hitchhiker's Guide to the Galaxy,45000000,51019112,102746214,2005,4,128.32,57746214
86,2007-09-21,Resident Evil: Extinction,45000000,50648679,149871103,2007,9,233.05,104871103
87,2004-12-25,Fat Albert,45000000,48114556,48563556,2004,12,7.92,3563556
88,2012-07-06,Savages,45000000,47323100,82513490,2012,7,83.36,37513490
90,2014-05-23,Blended,45000000,46290741,127990741,2014,5,184.42,82990741
91,2017-06-16,All Eyez on Me,45000000,44922302,54876855,2017,6,21.95,9876855
92,2006-01-13,Last Holiday,45000000,38399961,43343247,2006,1,-3.68,-1656753
93,2006-03-03,16 Blocks,45000000,36895141,65595141,2006,3,45.77,20595141
95,2004-09-10,Cellular,45000000,32003620,61475984,2004,9,36.61,16475984
96,2006-07-28,The Ant Bully,45000000,28142535,49610898,2006,7,10.25,4610898
97,2003-07-18,Johnny English,45000000,28013509,163126676,2003,7,262.5,118126676
99,2009-07-31,Aliens in the Attic,45000000,25200412,59551283,2009,7,32.34,14551283
100,2007-09-14,Across the Universe,45000000,24343673,29367143,2007,9,-34.74,-15632857
1,2008-12-26,Revolutionary Road,45000000,22951340,79604820,2008,12,76.9,34604820
2,2008-08-29,Babylon A.D.,45000000,22532572,70216497,2008,8,56.04,25216497
6,2019-05-03,UglyDolls,45000000,19894664,24644664,2019,5,-45.23,-20355336
7,2001-01-19,The Pledge,45000000,19719930,29406132,2001,1,-34.65,-15593868
8,2005-12-16,The Producers: The Movie Musical,45000000,19398532,32952995,2005,12,-26.77,-12047005
10,2005-07-01,Rebound,45000000,16809014,17492014,2005,7,-61.13,-27507986
11,2010-02-19,The Ghost Writer,45000000,15541549,65532491,2010,2,45.63,20532491
12,2000-12-22,All the Pretty Horses,45000000,15527125,18120267,2000,12,-59.73,-26879733
13,2008-09-05,Bangkok Dangerous,45000000,15298133,46598133,2008,9,3.55,1598133
15,2012-09-21,Dredd,45000000,13414714,41467606,2012,9,-7.85,-3532394
16,2011-10-28,The Rum Diary,45000000,13109815,21544732,2011,10,-52.12,-23455268
18,2018-12-21,Welcome to Marwen,45000000,10763520,12874922,2018,12,-71.39,-32125078
19,2011-10-21,Johnny English Reborn,45000000,8406711,164640401,2011,10,265.87,119640401
20,2008-09-26,Miracle at St. Anna,45000000,7916887,9676497,2008,9,-78.5,-35323503
21,2002-04-05,Big Trouble,45000000,7262288,8488871,2002,4,-81.14,-36511129
22,2006-12-21,Man cheng jin dai huang jin jia,45000000,6566773,76904429,2006,12,70.9,31904429
23,2007-11-16,Love in the Time of Cholera,45000000,4617608,31077418,2007,11,-30.94,-13922582
24,2002-12-25,Pinocchio,45000000,3681811,31681811,2002,12,-29.6,-13318189
26,2012-12-31,Foodfight!,45000000,0,73706,2012,12,-99.84,-44926294
27,2012-10-12,Argo,44500000,136025503,227140757,2012,10,410.43,182640757
31,2010-07-30,Charlie St. Cloud,44000000,31206263,48478084,2010,7,10.18,4478084
33,2014-02-06,The Interview,44000000,6105175,12342632,2014,2,-71.95,-31657368
35,2013-06-28,The Heat,43000000,159581587,229727774,2013,6,434.25,186727774
36,2000-12-19,Finding Forrester,43000000,51768623,80013623,2000,12,86.08,37013623
37,2000-04-14,28 Days,43000000,37035515,62063972,2000,4,44.33,19063972
38,2005-05-13,Danny the Dog,43000000,24537621,49037621,2005,5,14.04,6037621
39,2002-04-12,The Sweetest Thing,43000000,24430272,63078756,2002,4,46.69,20078756
40,2018-11-09,The Girl in the Spiderâs Web,43000000,14828555,34983342,2018,11,-18.64,-8016658
41,2017-01-06,A Monster Calls,43000000,3740823,46414530,2017,1,7.94,3414530
42,2011-01-28,The Mechanic,42500000,29121498,76347393,2011,1,79.64,33847393
44,2012-03-16,21 Jump Street,42000000,138447667,202812429,2012,3,382.89,160812429
46,2000-06-21,Chicken Run,42000000,106793915,227793915,2000,6,442.37,185793915
47,2004-01-16,Along Came Polly,42000000,88073507,173044410,2004,1,312.01,131044410
49,2009-07-10,BrÃ¼no,42000000,60054530,138708527,2009,7,230.26,96708527
51,2017-05-12,Snatched,42000000,45852178,57852177,2017,5,37.74,15852177
52,2012-10-12,Here Comes the Boom,42000000,45290318,73239258,2012,10,74.38,31239258
53,2002-04-05,High Crimes,42000000,41543207,63781100,2002,4,51.86,21781100
55,2011-03-11,Red Riding Hood,42000000,37662162,91678442,2011,3,118.28,49678442
56,2002-01-25,The Mothman Prophecies,42000000,35228696,56438555,2002,1,34.38,14438555
58,2018-12-25,Holmes & Watson,42000000,30568743,41926605,2018,12,-0.17,-73395
59,2012-01-27,One for the Money,42000000,26414527,36197221,2012,1,-13.82,-5802779
60,2001-03-09,15 Minutes,42000000,24375436,56331864,2001,3,34.12,14331864
61,2005-09-16,Lord of War,42000000,24149632,60437727,2005,9,43.9,18437727
64,2012-01-27,Man on a Ledge,42000000,18620000,49621440,2012,1,18.15,7621440
65,2010-12-03,The Warrior's Way,42000000,5666340,8514325,2010,12,-79.73,-33485675
67,2010-05-28,Micmacs,42000000,1259693,11756922,2010,5,-72.01,-30243078
68,2006-12-31,Les BronzÃ©s 3: amis pour la vie,42000000,0,83833602,2006,12,99.6,41833602
69,2015-12-31,Pourquoi j'ai pas mangÃ© mon pÃ¨re,42000000,0,15451663,2015,12,-63.21,-26548337
70,2002-11-08,8 Mile,41000000,116724075,245768384,2002,11,499.44,204768384
71,2019-05-31,Rocketman,41000000,57342725,108642725,2019,5,164.98,67642725
72,2001-05-11,A Knightâs Tale,41000000,56083966,100622586,2001,5,145.42,59622586
73,2003-08-22,The Medallion,41000000,22108977,22108977,2003,8,-46.08,-18891023
74,2011-10-14,The Big Year,41000000,7204138,7684524,2011,10,-81.26,-33315476
76,2005-07-15,Wedding Crashers,40000000,209218368,283218368,2005,7,608.05,243218368
77,2010-06-11,The Karate Kid,40000000,176591618,351774938,2010,6,779.44,311774938
78,2015-02-13,Fifty Shades of Grey,40000000,166167230,570998101,2015,2,1327.5,530998101
79,2009-06-19,The Proposal,40000000,163958031,314709717,2009,6,686.77,274709717
80,2013-12-13,American Hustle,40000000,150117807,257878294,2013,12,544.7,217878294
81,2019-05-17,John Wick: Chapter 3 â Parabellum,40000000,141744320,256498033,2019,5,541.25,216498033
82,2003-12-25,Cheaper by the Dozen,40000000,138614544,190212113,2003,12,375.53,150212113
83,2014-07-25,Lucy,40000000,126573960,457507776,2014,7,1043.77,417507776
84,2013-12-25,Lone Survivor,40000000,125095601,149804632,2013,12,274.51,109804632
87,2003-07-25,Spy Kids 3-D: Game Over,40000000,111760631,167851995,2003,7,319.63,127851995
90,2016-06-10,The Conjuring 2: The Enfield Poltergeist,40000000,102470008,311262102,2016,6,678.16,271262102
91,2010-10-01,The Social Network,40000000,96962694,224922135,2010,10,462.31,184922135
92,2009-08-07,Julie & Julia,40000000,94125426,126646119,2009,8,216.62,86646119
93,2009-02-06,He's Just Not That Into You,40000000,93953653,181053657,2009,2,352.63,141053657
94,2017-02-10,John Wick: Chapter Two,40000000,92029184,171350009,2017,2,328.38,131350009
95,2016-01-15,Ride Along 2,40000000,90862685,124827316,2016,1,212.07,84827316
96,2006-04-14,Scary Movie 4,40000000,90710620,178710620,2006,4,346.78,138710620
97,2015-03-27,Get Hard,40000000,90411453,106511453,2015,3,166.28,66511453
98,2000-02-04,Scream 3,40000000,89138076,161838076,2000,2,304.6,121838076
100,2016-10-14,The Accountant,40000000,86260045,152962083,2016,10,282.41,112962083
1,2014-11-14,Dumb and Dumber To,40000000,86208010,156553592,2014,11,291.38,116553592
2,2014-04-25,The Other Woman,40000000,83911193,195111193,2014,4,387.78,155111193
4,2006-02-17,Eight Below,40000000,81612565,120455994,2006,2,201.14,80455994
6,2015-09-25,The Intern,40000000,75764672,197115710,2015,9,392.79,157115710
8,2004-10-29,Ray,40000000,75305995,124823094,2004,10,212.06,84823094
9,2005-04-01,Sin City,40000000,74103820,158527918,2005,4,296.32,118527918
10,2015-10-16,Bridge of Spies,40000000,72313754,162498338,2015,10,306.25,122498338
11,2008-02-22,Vantage Point,40000000,72266306,150886329,2008,2,277.22,110886329
12,2009-03-20,"I Love You, Man",40000000,72013010,92302502,2009,3,130.76,52302502
13,2001-11-09,Shallow Hal,40000000,70836296,70836296,2001,11,77.09,30836296
15,2006-01-27,Big Momma's House 2,40000000,70165972,137047376,2006,1,242.62,97047376
16,2018-09-21,The House with a Clock in its Walls,40000000,68549695,126331750,2018,9,215.83,86331750
17,2016-11-04,Hacksaw Ridge,40000000,67209615,168904682,2016,11,322.26,128904682
18,2001-03-02,The Mexican,40000000,66808615,145238250,2001,3,263.1,105238250
19,2009-08-28,The Final Destination,40000000,66477700,187384627,2009,8,368.46,147384627
20,2009-04-17,17 Again,40000000,64167069,139474906,2009,4,248.69,99474906
21,2011-02-18,Unknown,40000000,63686397,136123083,2011,2,240.31,96123083
22,2010-06-04,Get Him to the Greek,40000000,61153526,91455875,2010,6,128.64,51455875
23,2003-11-21,Gothika,40000000,59588068,141484812,2003,11,253.71,101484812
24,2001-11-30,Behind Enemy Lines,40000000,58855732,58855732,2001,11,47.14,18855732
25,2011-03-18,The Lincoln Lawyer,40000000,58009200,87145086,2011,3,117.86,47145086
26,2004-10-15,Shall We Dance?,40000000,57887882,118097882,2004,10,195.24,78097882
27,2006-08-25,Invincible,40000000,57806952,58501127,2006,8,46.25,18501127
28,2013-02-15,Escape From Planet Earth,40000000,57012977,74156610,2013,2,85.39,34156610
31,2014-11-26,Horrible Bosses 2,40000000,54445357,105945357,2014,11,164.86,65945357
32,2002-01-25,The Count of Monte Cristo,40000000,54228104,75389090,2002,1,88.47,35389090
33,2006-10-20,The Prestige,40000000,53089891,104407366,2006,10,161.02,64407366
34,2006-06-16,The Lake House,40000000,52330111,114830111,2006,6,187.08,74830111
35,2010-07-09,Predators,40000000,52000688,127234389,2010,7,218.09,87234389
36,2012-08-15,The Odd Life of Timothy Green,40000000,51853450,55249159,2012,8,38.12,15249159
38,2006-12-08,Apocalypto,40000000,50866635,121032272,2006,12,202.58,81032272
39,2007-02-14,Music and Lyrics,40000000,50572589,146196885,2007,2,265.49,106196885
41,2004-03-12,Secret Window,40000000,47958031,92111551,2004,3,130.28,52111551
42,2005-08-12,The Skeleton Key,40000000,47907715,92256918,2005,8,130.64,52256918
43,2014-06-20,Jersey Boys,40000000,47047013,65282732,2014,6,63.21,25282732
44,2008-05-02,Made of Honor,40000000,46012734,106548738,2008,5,166.37,66548738
48,2014-05-30,A Million Ways to Die in The West,40000000,42720965,86778557,2014,5,116.95,46778557
49,2011-08-12,Final Destination 5,40000000,42587643,155011165,2011,8,287.53,115011165
50,2018-11-16,Widows,40000000,42402632,73866088,2018,11,84.67,33866088
51,2005-04-08,Fever Pitch,40000000,42071069,50071069,2005,4,25.18,10071069
52,2007-12-25,Aliens vs. Predator - Requiem,40000000,41797066,128884494,2007,12,222.21,88884494
53,2007-12-25,The Water Horse: Legend of the Deep,40000000,40412817,103429755,2007,12,158.57,63429755
54,2014-07-18,Sex Tape,40000000,38543473,126069509,2014,7,215.17,86069509
55,2011-04-15,Scream 4,40000000,38180928,95989590,2011,4,139.97,55989590
57,2000-08-11,Autumn in New York,40000000,37752931,90717684,2000,8,126.79,50717684
58,2011-03-18,Paul,40000000,37412945,101162106,2011,3,152.91,61162106
59,2012-12-19,The Guilt Trip,40000000,37134215,41294674,2012,12,3.24,1294674
60,2011-08-26,Colombiana,40000000,36665854,72295262,2011,8,80.74,32295262
62,2018-01-12,The Commuter,40000000,36343858,101985431,2018,1,154.96,61985431
63,2000-02-18,Hanging Up,40000000,36037909,51867723,2000,2,29.67,11867723
66,2000-10-20,Pay it Forward,40000000,33508922,55696705,2000,10,39.24,15696705
67,2011-04-08,Arthur,40000000,33035397,47787943,2011,4,19.47,7787943
68,2008-03-21,Drillbit Taylor,40000000,32862104,49686263,2008,3,24.22,9686263
69,2016-12-21,Patriots Day,40000000,31886361,52837989,2016,12,32.09,12837989
70,2011-12-25,Extremely Loud and Incredibly Close,40000000,31847881,55247881,2011,12,38.12,15247881
72,2008-11-26,Transporter 3,40000000,31715062,107235592,2008,11,168.09,67235592
73,2010-11-10,Morning Glory,40000000,31011732,59795070,2010,11,49.49,19795070
74,2005-11-09,Get Rich or Die Tryin',40000000,30981850,46666955,2005,11,16.67,6666955
75,2019-05-03,Long Shot,40000000,30202860,43711031,2019,5,9.28,3711031
76,2000-08-25,The Art of War,40000000,30199105,30199105,2000,8,-24.5,-9800895
77,2013-12-25,Grudge Match,40000000,29807260,69807260,2013,12,74.52,29807260
78,2000-08-11,Bless the Child,40000000,29374178,40435694,2000,8,1.09,435694
79,2005-11-23,Rent,40000000,29077547,31670620,2005,11,-20.82,-8329380
81,2017-08-11,The Nut Job 2: Nutty by Nature,40000000,28370522,57438389,2017,8,43.6,17438389
83,2001-09-07,The Musketeer,40000000,27053815,27053815,2001,9,-32.37,-12946185
84,2017-01-27,Resident Evil: The Final Chapter,40000000,26844692,314101190,2017,1,685.25,274101190
85,2008-02-29,The Other Boleyn Girl,40000000,26814957,78269970,2008,2,95.67,38269970
86,2017-06-30,The House,40000000,25584504,31192425,2017,6,-22.02,-8807575
87,2001-02-16,Sweet November,40000000,25288103,65754228,2001,2,64.39,25754228
88,2007-04-05,The Reaping,40000000,25126214,62226214,2007,4,55.57,22226214
89,2011-01-07,Season of the Witch,40000000,24827228,91126600,2011,1,127.82,51126600
92,2002-09-06,City by the Sea,40000000,22433915,22433915,2002,9,-43.92,-17566085
94,2016-08-26,Mechanic: Resurrection,40000000,21218403,109738840,2016,8,174.35,69738840
95,2004-01-16,Torque,40000000,21176322,46176322,2004,1,15.44,6176322
96,2009-11-13,Fantastic Mr. Fox,40000000,21002919,47083412,2009,11,17.71,7083412
99,2012-02-03,Big Miracle,40000000,20157300,25268680,2012,2,-36.83,-14731320
100,2012-12-21,The Impossible,40000000,19019882,169590606,2012,12,323.98,129590606
1,2012-03-09,A Thousand Words,40000000,18450127,20790486,2012,3,-48.02,-19209514
2,2006-10-20,Marie Antoinette,40000000,15962471,60862471,2006,10,52.16,20862471
3,2000-10-06,Get Carter,40000000,14967182,19417182,2000,10,-51.46,-20582818
5,2002-04-26,"Life, or Something Like It",40000000,14448589,14448589,2002,4,-63.88,-25551411
8,2009-10-23,Amelia,40000000,14279575,19756077,2009,10,-50.61,-20243923
9,2009-10-23,Cirque du Freak: The Vampire's Assistant,40000000,14046595,39753957,2009,10,-0.62,-246043
10,2004-05-07,New York Minute,40000000,14018364,21215882,2004,5,-46.96,-18784118
12,2004-11-05,Alfie,40000000,13395939,35195939,2004,11,-12.01,-4804061
13,2002-08-30,FearDotCom,40000000,13208023,13208023,2002,8,-66.98,-26791977
14,2008-11-07,Soul Men,40000000,12082391,12345883,2008,11,-69.14,-27654117
15,2015-03-20,The Gunman,40000000,10664749,18594227,2015,3,-53.51,-21405773
17,2009-09-25,Pandorum,40000000,10330853,17033431,2009,9,-57.42,-22966569
18,2003-09-26,Duplex,40000000,9652000,10070651,2003,9,-74.82,-29929349
19,2013-08-16,Paranoia,40000000,7388654,16340767,2013,8,-59.15,-23659233
21,2015-07-10,Baahubali: The Beginning,40000000,6738000,26736665,2015,7,-33.16,-13263335
22,2018-03-09,The Hurricane Heist,40000000,6115824,30963684,2018,3,-22.59,-9036316
23,2002-01-04,Impostor,40000000,6114237,7974607,2002,1,-80.06,-32025393
24,2015-11-25,Victor Frankenstein,40000000,5775076,31124367,2015,11,-22.19,-8875633
25,2002-11-27,Extreme Ops,40000000,4835968,12624471,2002,11,-68.44,-27375529
26,2001-04-06,Just Visiting,40000000,4777007,16172200,2001,4,-59.57,-23827800
27,2014-06-27,Snowpiercer,40000000,4563029,88069880,2014,6,120.17,48069880
28,2007-07-20,Sunshine,40000000,3688560,32030610,2007,7,-19.92,-7969390
30,2016-11-11,Billy Lynnâs Long Halftime Walk,40000000,1738477,30230402,2016,11,-24.42,-9769598
32,2008-12-12,Delgo,40000000,915840,915840,2008,12,-97.71,-39084160
33,2007-09-07,The Hunting Party,40000000,876671,7729552,2007,9,-80.68,-32270448
34,2006-10-13,Alex Rider: Operation Stormbreaker,40000000,659210,20722450,2006,10,-48.19,-19277550
35,2009-11-20,Red Cliff,40000000,627047,119627047,2009,11,199.07,79627047
36,2004-09-24,The Last Shot,40000000,463730,463730,2004,9,-98.84,-39536270
37,2007-03-16,Nomad,40000000,79123,79123,2007,3,-99.8,-39920877
38,2013-04-16,Un monstre Ã Paris,40000000,0,27000381,2013,4,-32.5,-12999619
39,2019-06-21,Kursk,40000000,0,4212799,2019,6,-89.47,-35787201
40,2016-11-11,USS Indianapolis: Men of Courage,40000000,0,1663785,2016,11,-95.84,-38336215
41,2014-12-31,Dragon Nest Warriors' Dawn,40000000,0,734423,2014,12,-98.16,-39265577
45,2009-08-14,The Time Traveler's Wife,39000000,63414846,102332135,2009,8,162.39,63332135
47,2007-02-02,Because I Said So,39000000,42674040,69538833,2007,2,78.3,30538833
48,2012-10-05,Frankenweenie,39000000,35287788,81150788,2012,10,108.08,42150788
50,2005-09-30,Serenity,39000000,25514517,40319440,2005,9,3.38,1319440
51,2007-09-07,Shoot 'Em Up,39000000,12796824,26796824,2007,9,-31.29,-12203176
52,2004-02-20,Against the Ropes,39000000,5881504,6429865,2004,2,-83.51,-32570135
53,2013-08-23,Yi dai zong shi,38600000,6594959,57987299,2013,8,50.23,19387299
54,2001-06-22,The Fast and the Furious,38000000,144512310,206512310,2001,6,443.45,168512310
55,2002-09-27,Sweet Home Alabama,38000000,127214072,182365114,2002,9,379.91,144365114
56,2009-07-24,The Ugly Truth,38000000,88915214,205298907,2009,7,440.26,167298907
57,2002-08-07,Spy Kids 2: The Island of Lost Dreams,38000000,85846296,119721296,2002,8,215.06,81721296
59,2017-06-02,Captain Underpants: The First Epic Movie,38000000,73921000,126577874,2017,6,233.1,88577874
60,2015-04-17,Paul Blart: Mall Cop 2,38000000,71091594,107650646,2015,4,183.29,69650646
62,2016-12-23,Why Him?,38000000,60323786,117425156,2016,12,209.01,79425156
63,2011-04-22,Water for Elephants,38000000,58709717,116809717,2011,4,207.39,78809717
64,2010-10-08,Life as We Know It,38000000,53374681,105887837,2010,10,178.65,67887837
66,2013-09-06,Riddick,38000000,42025135,94763758,2013,9,149.38,56763758
67,2001-03-23,Heartbreakers,38000000,40334024,57753825,2001,3,51.98,19753825
68,2002-05-24,Enough,38000000,39177215,50970660,2002,5,34.13,12970660
69,2016-01-22,The 5th Wave,38000000,34912982,111336398,2016,1,192.99,73336398
70,2009-02-06,Push,38000000,31811527,49678401,2009,2,30.73,11678401
71,2013-09-20,Rush,38000000,26947624,98230839,2013,9,158.5,60230839
72,2001-05-18,Angel Eyes,38000000,24044532,29544532,2001,5,-22.25,-8455468
73,2001-12-21,Joe Somebody,38000000,22770864,24515990,2001,12,-35.48,-13484010
74,2000-03-10,The Ninth Gate,38000000,18653746,58394308,2000,3,53.67,20394308
75,2017-10-20,Only the Brave,38000000,18340051,24555177,2017,10,-35.38,-13444823
77,2011-10-14,The Thing,38000000,16999934,27573078,2011,10,-27.44,-10426922
78,2001-09-07,Rock Star,38000000,16991902,19317765,2001,9,-49.16,-18682235
80,2008-10-10,City of Ember,38000000,7873007,17831558,2008,10,-53.07,-20168442
82,2018-09-21,The Sisters Brothers,38000000,3143056,13143056,2018,9,-65.41,-24856944
83,2001-11-30,Texas Rangers,38000000,623374,623374,2001,11,-98.36,-37376626
84,2008-08-26,Virgin Territory,38000000,0,5473041,2008,8,-85.6,-32526959
85,2019-01-11,The Upside,37500000,108235497,119024536,2019,1,217.4,81524536
86,2012-05-18,What to Expect When You're Expecting,37500000,41152203,88473016,2012,5,135.93,50973016
87,2012-09-14,The Master,37500000,16247159,50647416,2012,9,35.06,13147416
88,2008-10-10,The Express,37500000,9793406,9813309,2008,10,-73.83,-27686691
89,2008-11-21,Twilight,37000000,192769854,402280159,2008,11,987.24,365280159
90,2013-08-07,We're the Millers,37000000,150394119,267816276,2013,8,623.83,230816276
91,2015-11-25,Creed,37000000,109767581,173567581,2015,11,369.1,136567581
92,2010-09-17,The Town,37000000,92186262,152566881,2010,9,312.34,115566881
93,2011-09-23,Dolphin Tale,37000000,72286779,96068724,2011,9,159.65,59068724
94,2018-02-23,Game Night,37000000,69179066,117378084,2018,2,217.24,80378084
95,2008-09-12,Burn After Reading,37000000,60355347,168167798,2008,9,354.51,131167798
96,2004-04-23,13 Going On 30,37000000,57139723,97658712,2004,4,163.94,60658712
97,2008-04-04,Nim's Island,37000000,48006762,101857425,2008,4,175.29,64857425
98,2016-02-12,How to be Single,37000000,46843513,100003780,2016,2,170.28,63003780
99,2010-02-26,Cop Out,37000000,44875481,55909910,2010,2,51.11,18909910
100,2011-01-28,The Rite,37000000,33047633,97143987,2011,1,162.55,60143987
1,2008-07-18,Space Chimps,37000000,30105968,67029956,2008,7,81.16,30029956
3,2015-05-29,Aloha,37000000,21052030,25387091,2015,5,-31.39,-11612909
4,2009-12-31,Obitaemyy ostrov,36500000,0,15000000,2009,12,-58.9,-21500000
5,2018-10-05,A Star is Born,36000000,215288866,433449571,2018,10,1104.03,397449571
6,2011-02-11,Gnomeo and Juliet,36000000,99967670,193737977,2011,2,438.16,157737977
7,2002-02-15,John Q,36000000,71026631,102226631,2002,2,183.96,66226631
10,2010-03-26,Hot Tub Time Machine,36000000,50269859,65967750,2010,3,83.24,29967750
12,2014-09-12,Dolphin Tale 2,36000000,42024533,57824533,2014,9,60.62,21824533
13,2016-12-16,Collateral Beauty,36000000,31016021,85309093,2016,12,136.97,49309093
14,2003-04-04,A Man Apart,36000000,26500000,43797731,2003,4,21.66,7797731
15,2000-02-25,Reindeer Games,36000000,23360779,23360779,2000,2,-35.11,-12639221
19,2000-01-28,Isn't She Great,36000000,2954405,2954405,2000,1,-91.79,-33045595
20,2016-01-22,Yip Man 3,36000000,2679437,157300954,2016,1,336.95,121300954
21,2011-05-06,There Be Dragons,36000000,1069334,4020990,2011,5,-88.83,-31979010
22,2017-04-14,Queen of the Desert,36000000,0,1578543,2017,4,-95.62,-34421457
23,2003-03-28,Head of State,35200000,37788228,38283765,2003,3,8.76,3083765
24,2017-09-08,It,35000000,327481748,697457969,2017,9,1892.74,662457969
25,2009-06-05,The Hangover,35000000,277322503,465764086,2009,6,1230.75,430764086
26,2009-11-20,The Blind Side,35000000,255959475,305705794,2009,11,773.45,270705794
29,2010-12-22,True Grit,35000000,171243005,252276928,2010,12,620.79,217276928
32,2013-02-08,Identity Thief,35000000,134506920,175361578,2013,2,401.03,140361578
33,2006-06-30,The Devil Wears Prada,35000000,124740460,326073155,2006,6,831.64,291073155
34,2011-07-08,Horrible Bosses,35000000,117538559,212417601,2011,7,506.91,177417601
35,2001-03-30,Spy Kids,35000000,112692062,197692062,2001,3,464.83,162692062
36,2015-07-17,Trainwreck,35000000,110212700,141123897,2015,7,303.21,106123897
37,2013-12-13,Saving Mr. Banks,35000000,83299761,114962525,2013,12,228.46,79962525
39,2008-03-28,21,35000000,81159365,159846429,2008,3,356.7,124846429
40,2008-05-09,What Happens in Vegas...,35000000,80277646,218535708,2008,5,524.39,183535708
43,2009-01-16,Hotel for Dogs,35000000,73178547,122357172,2009,1,249.59,87357172
44,2005-03-25,Guess Who,35000000,68915888,102115888,2005,3,191.76,67115888
45,2012-12-21,This is 40,35000000,67544505,90221182,2012,12,157.77,55221182
47,2005-07-29,Sky High,35000000,63939454,83109359,2005,7,137.46,48109359
49,2010-04-30,A Nightmare on Elm Street,35000000,63075011,117729621,2010,4,236.37,82729621
50,2000-08-18,The Cell,35000000,61280963,85911226,2000,8,145.46,50911226
52,2006-04-07,The Benchwarmers,35000000,59843754,65063726,2006,4,85.9,30063726
53,2010-10-08,Secretariat,35000000,59699513,60376247,2010,10,72.5,25376247
55,2011-07-22,Friends with Benefits,35000000,55802754,146595891,2011,7,318.85,111595891
56,2016-05-20,Neighbors 2: Sorority Rising,35000000,55340730,108757621,2016,5,210.74,73757621
57,2007-03-23,TMNT,35000000,54149098,96096018,2007,3,174.56,61096018
58,2003-10-24,Radio,35000000,52333738,53293628,2003,10,52.27,18293628
59,2018-06-29,Sicario: Day of the Soldado,35000000,50065850,75885196,2018,6,116.81,40885196
60,2009-11-25,Old Dogs,35000000,49492060,95104304,2009,11,171.73,60104304
62,2015-05-22,Poltergeist,35000000,47425125,95713069,2015,5,173.47,60713069
63,2018-10-12,Goosebumps 2: Haunted Halloween,35000000,46697321,93291478,2018,10,166.55,58291478
64,2018-01-19,12 Strong,35000000,45819713,71118378,2018,1,103.2,36118378
65,2009-01-23,Underworld 3: Rise of the Lycans,35000000,45802315,89102315,2009,1,154.58,54102315
66,2005-07-29,Must Love Dogs,35000000,43894863,58405313,2005,7,66.87,23405313
67,2007-07-03,License to Wed,35000000,43799818,70187088,2007,7,100.53,35187088
69,2008-10-17,Max Payne,35000000,40689393,87775050,2008,10,150.79,52775050
70,2002-03-15,Resident Evil,35000000,40119709,103787401,2002,3,196.54,68787401
71,2004-03-26,The Ladykillers,35000000,39692139,77392139,2004,3,121.12,42392139
72,2011-05-06,Something Borrowed,35000000,39046489,65084116,2011,5,85.95,30084116
73,2006-12-01,The Nativity Story,35000000,37629831,46309644,2006,12,32.31,11309644
74,2011-10-28,In Time,35000000,37553932,165103952,2011,10,371.73,130103952
75,2010-04-23,The Back-up Plan,35000000,37490007,75281179,2010,4,115.09,40281179
76,2011-11-09,J. Edgar,35000000,37306030,84606030,2011,11,141.73,49606030
77,2000-11-17,Bounce,35000000,36805288,53425292,2000,11,52.64,18425292
78,2018-08-17,Mile 22,35000000,36108758,66295121,2018,8,89.41,31295121
79,2015-05-08,Hot Pursuit,35000000,34580201,45671512,2015,5,30.49,10671512
80,2015-12-25,Concussion,35000000,34531832,50363790,2015,12,43.9,15363790
81,2017-10-13,The Foreigner,35000000,34393507,140783360,2017,10,302.24,105783360
82,2004-12-03,Closer,35000000,33987757,116177695,2004,12,231.94,81177695
84,2001-11-21,Black Knight,35000000,33422806,33422806,2001,11,-4.51,-1577194
85,2005-07-22,The Bad News Bears,35000000,32868349,33500620,2005,7,-4.28,-1499380
86,2002-12-27,The Pianist,35000000,32519322,111854182,2002,12,219.58,76854182
87,2005-05-06,House of Wax,35000000,32064800,70064800,2005,5,100.19,35064800
88,2001-10-19,From Hell,35000000,31598308,68712365,2001,10,96.32,33712365
89,2018-06-01,Adrift,35000000,31445011,57897191,2018,6,65.42,22897191
90,2008-08-15,Mirrors,35000000,30691439,77220596,2008,8,120.63,42220596
91,2017-01-06,Underworld: Blood Wars,35000000,30353973,81209222,2017,1,132.03,46209222
92,2002-02-22,Queen of the Damned,35000000,30307804,30307804,2002,2,-13.41,-4692196
93,2010-08-20,Nanny McPhee and the Big Bang,35000000,29197642,97799865,2010,8,179.43,62799865
94,2008-01-25,Untraceable,35000000,28687835,52649951,2008,1,50.43,17649951
96,2011-09-23,Abduction,35000000,28087155,86648359,2011,9,147.57,51648359
98,2008-03-28,Superhero Movie,35000000,26638520,73026302,2008,3,108.65,38026302
100,2012-10-19,Alex Cross,35000000,25888412,35426759,2012,10,1.22,426759
1,2004-03-26,Jersey Girl,35000000,25266129,37066129,2004,3,5.9,2066129
3,2016-09-16,Bridget Jonesâs Baby,35000000,24139805,205822688,2016,9,488.06,170822688
4,2001-11-09,Heist,35000000,23483357,28906817,2001,11,-17.41,-6093183
6,2016-03-04,Whiskey Tango Foxtrot,35000000,23083334,25350747,2016,3,-27.57,-9649253
7,2004-04-09,Ella Enchanted,35000000,22913677,22913677,2004,4,-34.53,-12086323
8,2015-08-21,Hitman: Agent 47,35000000,22467450,82182803,2015,8,134.81,47182803
9,2008-07-25,The X-Files: I Want to Believe,35000000,20982478,68170792,2008,7,94.77,33170792
10,2012-08-24,Premium Rush,35000000,20275446,31393201,2012,8,-10.31,-3606799
11,2013-01-18,Broken City,35000000,19701164,34480045,2013,1,-1.49,-519955
12,2005-08-19,Valiant,35000000,19478106,64188387,2005,8,83.4,29188387
13,2000-02-23,Wonder Boys,35000000,19389454,33422485,2000,2,-4.51,-1577515
14,2005-02-25,Cursed,35000000,19294901,25114901,2005,2,-28.24,-9885099
15,2007-12-21,Walk Hard: The Dewey Cox Story,35000000,18317151,20606053,2007,12,-41.13,-14393947
16,2002-09-20,The Four Feathers,35000000,18306166,29882645,2002,9,-14.62,-5117355
17,2010-04-30,Furry Vengeance,35000000,17630465,39340177,2010,4,12.4,4340177
18,2013-01-25,Parker,35000000,17616641,48543388,2013,1,38.7,13543388
19,2004-09-17,Wimbledon,35000000,16862585,41666476,2004,9,19.05,6666476
20,2000-09-15,Bait,35000000,15325127,15471969,2000,9,-55.79,-19528031
21,2000-12-08,Dungeons and Dragons,35000000,15185241,33771965,2000,12,-3.51,-1228035
22,2007-11-09,Lions for Lambs,35000000,14998070,63211088,2007,11,80.6,28211088
24,2011-05-27,The Tree of Life,35000000,13305665,61721826,2011,5,76.35,26721826
25,2001-08-17,American Outlaws,35000000,13264986,13601109,2001,8,-61.14,-21398891
26,2006-08-11,Zoom,35000000,11989328,12506188,2006,8,-64.27,-22493812
27,2001-12-25,The Shipping News,35000000,11405825,24405825,2001,12,-30.27,-10594175
28,2009-12-18,The Young Victoria,35000000,11001272,31878891,2009,12,-8.92,-3121109
29,2014-03-28,Sabotage,35000000,10508518,18376443,2014,3,-47.5,-16623557
31,2009-09-11,Whiteout,35000000,10275638,12254746,2009,9,-64.99,-22745254
32,2015-03-06,Unfinished Business,35000000,10219501,13214051,2015,3,-62.25,-21785949
33,2015-09-30,The Walk,35000000,10161183,61492104,2015,9,75.69,26492104
34,2006-11-22,The Fountain,35000000,10144010,15461638,2006,11,-55.82,-19538362
35,2013-11-29,Mandela: Long Walk to Freedom,35000000,8323085,29890402,2013,11,-14.6,-5109598
36,2008-12-05,Punisher: War Zone,35000000,8050977,10157534,2008,12,-70.98,-24842466
37,2003-09-05,The Order,35000000,7659747,11559747,2003,9,-66.97,-23440253
38,2006-11-10,A Good Year,35000000,7459300,42064105,2006,11,20.18,7064105
39,2016-03-11,The Brothers Grimsby,35000000,6864016,28720470,2016,3,-17.94,-6279530
40,2017-10-20,The Snowman,35000000,6670765,43226146,2017,10,23.5,8226146
41,2002-11-06,Femme Fatale,35000000,6630252,16830252,2002,11,-51.91,-18169748
43,2003-09-26,Luther,35000000,5781086,32717063,2003,9,-6.52,-2282937
44,2011-01-28,Biutiful,35000000,5101237,24687524,2011,1,-29.46,-10312476
47,2016-04-22,A Hologram for the King,35000000,4212494,11846010,2016,4,-66.15,-23153990
53,2012-09-14,Stolen,35000000,289773,17967746,2012,9,-48.66,-17032254
54,2011-10-14,Trespass,35000000,16816,786532,2011,10,-97.75,-34213468
55,2006-09-22,Bandidas,35000000,0,19282590,2006,9,-44.91,-15717410
56,2015-03-13,The Lovers,35000000,0,53899,2015,3,-99.85,-34946101
58,2011-12-25,The Darkest Hour,34800000,21443494,62831715,2011,12,80.55,28031715
59,2017-06-28,Baby Driver,34000000,107825862,228104185,2017,6,570.89,194104185
60,2014-09-19,The Maze Runner,34000000,102427862,348319861,2014,9,924.47,314319861
61,2015-04-10,The Longest Ride,34000000,37446117,63802928,2015,4,87.66,29802928
63,2009-08-14,Gake no ue no Ponyo,34000000,15090399,205312666,2009,8,503.86,171312666
64,2018-08-03,The Darkest Minds,34000000,12695691,38361428,2018,8,12.83,4361428
67,2000-05-05,I Dreamed of Africa,34000000,6543194,14291999,2000,5,-57.96,-19708001
68,2014-09-05,Thunder and the House of Magic,34000000,4091,62582520,2014,9,84.07,28582520
71,2000-06-02,Big Momma's House,33000000,117559438,173559438,2000,6,425.94,140559438
72,2001-03-16,Exit Wounds,33000000,51758599,79958599,2001,3,142.3,46958599
73,2016-07-08,Mike and Dave Need Wedding Dates,33000000,46009673,75898100,2016,7,129.99,42898100
74,2012-07-27,Step Up Revolution,33000000,35074677,165552290,2012,7,401.67,132552290
75,2006-08-18,Snakes on a Plane,33000000,34020814,62020814,2006,8,87.94,29020814
76,2004-04-16,The Punisher,33000000,33664370,54533774,2004,4,65.25,21533774
77,2000-09-08,The Watcher,33000000,28946615,47267829,2000,9,43.24,14267829
78,2012-04-27,Safe,33000000,17142080,41495213,2012,4,25.74,8495213
79,2008-03-14,Doomsday,33000000,11008770,21621188,2008,3,-34.48,-11378812
81,2006-05-12,Goal! The Dream Begins,33000000,4283255,27610873,2006,5,-16.33,-5389127
82,2015-07-31,The Young and Prodigious T.S. Spivet,33000000,176847,357687,2015,7,-98.92,-32642313
83,2015-10-30,Freaks of Nature,33000000,70958,70958,2015,10,-99.78,-32929042
85,2011-05-13,Bridesmaids,32500000,169211718,289632023,2011,5,791.18,257132023
86,2008-12-10,The Reader,32500000,34194407,112964875,2008,12,247.58,80464875
87,2013-04-26,The Big Wedding,32500000,21819348,48425971,2013,4,49.0,15925971
88,2012-02-24,Wanderlust,32500000,17288155,24159934,2012,2,-25.66,-8340066
89,2003-11-07,Elf,32000000,173840591,220678483,2003,11,589.62,188678483
91,2013-06-12,This is the End,32000000,101470202,126539117,2013,6,295.43,94539117
92,2002-01-18,Snow Dogs,32000000,81150692,116898028,2002,1,265.31,84898028
93,2006-06-16,Nacho Libre,32000000,80197993,99296462,2006,6,210.3,67296462
95,2010-08-27,Takers,32000000,57744720,70587268,2010,8,120.59,38587268
96,2011-04-01,Source Code,32000000,54712227,140428499,2011,4,338.84,108428499
98,2000-11-10,Men of Honor,32000000,48814909,82339483,2000,11,157.31,50339483
99,2018-04-20,I Feel Pretty,32000000,48795601,91553797,2018,4,186.11,59553797
100,2005-09-02,The Transporter 2,32000000,43095856,88978458,2005,9,178.06,56978458
1,2011-02-18,"Big Mommas: Like Father, Like Son",32000000,37915414,82332450,2011,2,157.29,50332450
3,2007-02-23,The Number 23,32000000,35193167,77593167,2007,2,142.48,45593167
5,2005-10-21,Dreamer: Inspired by a True Story,32000000,33022286,39498360,2005,10,23.43,7498360
6,2005-09-23,A History of Violence,32000000,31493782,61477797,2005,9,92.12,29477797
7,2013-03-15,The Incredible Burt Wonderstone,32000000,22537881,27392609,2013,3,-14.4,-4607391
9,2004-04-30,Laws of Attraction,32000000,17848322,29948322,2004,4,-6.41,-2051678
10,2018-10-12,Bad Times at the El Royale,32000000,17839115,29204379,2018,10,-8.74,-2795621
11,2010-09-03,Going the Distance,32000000,17804299,43603990,2010,9,36.26,11603990
13,2010-03-19,Repo Men,32000000,13942007,18195238,2010,3,-43.14,-13804762
14,2007-09-14,Dragon Wars: D-War,32000000,10977721,79915361,2007,9,149.74,47915361
18,2006-12-15,The Good German,32000000,1308696,6678033,2006,12,-79.13,-25321967
21,2016-04-15,Criminal,31500000,14708696,38771262,2016,4,23.08,7271262
22,2013-04-12,42,31000000,95020213,97470701,2013,4,214.42,66470701
23,2012-11-02,Flight,31000000,93772375,160558438,2012,11,417.93,129558438
27,2014-03-07,The Grand Budapest Hotel,31000000,59076019,163981261,2014,3,428.97,132981261
28,2015-07-29,Vacation,31000000,58884188,102306500,2015,7,230.02,71306500
30,2019-02-13,Isnât it Romantic,31000000,48791187,48791187,2019,2,57.39,17791187
31,2000-04-28,Frequency,31000000,44983704,68079671,2000,4,119.61,37079671
32,2001-09-28,Hearts in Atlantis,31000000,24185781,30885781,2001,9,-0.37,-114219
33,2010-01-22,Extraordinary Measures,31000000,12482741,15826984,2010,1,-48.95,-15173016
34,2017-08-25,Birth of the Dragon,31000000,6901965,7220490,2017,8,-76.71,-23779510
38,2018-08-15,Crazy Rich Asians,30000000,174532921,238099711,2018,8,693.67,208099711
39,2002-12-27,Chicago,30000000,170687518,306770545,2002,12,922.57,276770545
41,2001-08-10,American Pie 2,30000000,145096820,286500000,2001,8,855.0,256500000
42,2012-02-10,The Vow,30000000,125014030,197618160,2012,2,558.73,167618160
45,2013-08-16,Lee Daniels' The Butler,30000000,116632095,177025498,2013,8,490.08,147025498
46,2000-09-29,Remember the Titans,30000000,115654751,136706683,2000,9,355.69,106706683
47,2009-08-14,District 9,30000000,115646235,212453431,2009,8,608.18,182453431
48,2004-06-18,Dodgeball: A True Underdog Story,30000000,114326736,167791704,2004,6,459.31,137791704
51,2001-08-03,The Princess Diaries,30000000,108244774,165334774,2001,8,451.12,135334774
54,2004-12-15,Million Dollar Baby,30000000,100492203,231928227,2004,12,673.09,201928227
56,2003-10-08,Mystic River,30000000,90135191,156822020,2003,10,422.74,126822020
57,2015-12-18,Sisters,30000000,87044645,106030660,2015,12,253.44,76030660
59,2004-11-19,SpongeBob SquarePants: The Movie,30000000,85416609,142051255,2004,11,373.5,112051255
60,2009-12-04,Up in the Air,30000000,83823381,166842739,2009,12,456.14,136842739
61,2004-06-25,The Notebook,30000000,81001787,116025023,2004,6,286.75,86025023
62,2009-04-10,Hannah Montana the Movie,30000000,79576189,169173206,2009,4,463.91,139173206
63,2008-01-18,27 Dresses,30000000,76808654,160247805,2008,1,434.16,130247805
64,2000-11-17,Rugrats in Paris,30000000,76501438,103284813,2000,11,244.28,73284813
65,2017-08-18,The Hitmanâs Bodyguard,30000000,75468583,172778667,2017,8,475.93,142778667
67,2005-08-12,Four Brothers,30000000,74494381,92494381,2005,8,208.31,62494381
69,2012-09-28,Looper,30000000,66486205,170466405,2012,9,468.22,140466405
70,2013-02-01,Warm Bodies,30000000,66380662,115121608,2013,2,283.74,85121608
71,2002-12-13,About Schmidt,30000000,65005217,107054484,2002,12,256.85,77054484
72,2014-01-17,The Nut Job,30000000,64251538,122529966,2014,1,308.43,92529966
73,2001-02-16,Down to Earth,30000000,64172251,71172251,2001,2,137.24,41172251
75,2012-08-08,Hope Springs,30000000,63536011,133085295,2012,8,343.62,103085295
76,2008-04-18,Forgetting Sarah Marshall,30000000,63172463,105173042,2008,4,250.58,75173042
77,2004-10-08,Friday Night Lights,30000000,61255921,61950770,2004,10,106.5,31950770
79,2008-04-25,Baby Mama,30000000,60494212,64170447,2008,4,113.9,34170447
81,2009-01-09,Bride Wars,30000000,58715510,115150424,2009,1,283.83,85150424
82,2004-08-20,Without a Paddle,30000000,58156435,65121280,2004,8,117.07,35121280
83,2011-05-20,Midnight in Paris,30000000,56816662,162502774,2011,5,441.68,132502774
84,2017-11-22,Darkest Hour,30000000,56443120,150807172,2017,11,402.69,120807172
85,2005-10-05,Wallace & Gromit: The Curse of the Were-Rabbit,30000000,56068547,197593152,2005,10,558.64,167593152
86,2007-12-21,P.S. I Love You,30000000,53695808,155769678,2007,12,419.23,125769678
87,2005-09-23,Corpse Bride,30000000,53359111,114770654,2005,9,282.57,84770654
88,2018-05-11,Life of the Party,30000000,53059911,65759911,2018,5,119.2,35759911
89,2010-05-14,Letters to Juliet,30000000,53032453,82148538,2010,5,173.83,52148538
90,2001-04-06,Blow,30000000,52990775,83282296,2001,4,177.61,53282296
92,2015-07-24,Southpaw,30000000,52421953,94156456,2015,7,213.85,64156456
94,2017-07-28,Atomic Blonde,30000000,51573925,98345423,2017,7,227.82,68345423
95,2002-07-03,Like Mike,30000000,51432423,62432423,2002,7,108.11,32432423
97,2007-12-07,Atonement,30000000,50980159,129779728,2007,12,332.6,99779728
99,2005-01-14,Racing Stripes,30000000,49772522,89955540,2005,1,199.85,59955540
100,2015-09-18,Sicario,30000000,46889293,84393749,2015,9,181.31,54393749
3,2018-01-19,Den of Thieves,30000000,44947622,80131391,2018,1,167.1,50131391
4,2012-04-13,The Three Stooges,30000000,44338224,54052249,2012,4,80.17,24052249
5,2000-07-21,Pokemon 2000,30000000,43746923,133946923,2000,7,346.49,103946923
6,2014-10-24,John Wick,30000000,43037835,76235001,2014,10,154.12,46235001
7,2006-01-13,Glory Road,30000000,42647449,42799060,2006,1,42.66,12799060
8,2015-04-24,The Age of Adaline,30000000,42629776,68984536,2015,4,129.95,38984536
9,2010-08-06,Step Up 3D,30000000,42400223,165889117,2010,8,452.96,135889117
10,2009-05-29,Drag Me To Hell,30000000,42100625,91388487,2009,5,204.63,61388487
11,2012-04-13,The Cabin in the Woods,30000000,42073277,70689968,2012,4,135.63,40689968
12,2003-09-19,Secondhand Lions,30000000,42070939,47902566,2003,9,59.68,17902566
13,2006-11-10,Stranger Than Fiction,30000000,40435190,53572822,2006,11,78.58,23572822
14,2011-04-08,Hanna,30000000,40259119,65343694,2011,4,117.81,35343694
15,2002-08-16,Blue Crush,30000000,40118420,51618420,2002,8,72.06,21618420
16,2007-10-19,30 Days of Night,30000000,39568996,80276156,2007,10,167.59,50276156
18,2006-09-15,Gridiron Gang,30000000,38432823,41457834,2006,9,38.19,11457834
20,2008-01-25,Meet the Spartans,30000000,38233676,84646831,2008,1,182.16,54646831
22,2013-09-13,The Family,30000000,36918811,51078541,2013,9,70.26,21078541
23,2018-02-09,The 15:17 to Paris,30000000,36276286,56096200,2018,2,86.99,26096200
25,2011-07-01,Larry Crowne,30000000,35608245,61449135,2011,7,104.83,31449135
26,2013-10-18,Carrie,30000000,35266619,82409520,2013,10,174.7,52409520
27,2006-04-07,Take the Lead,30000000,34742066,65390493,2006,4,117.97,35390493
28,2018-03-02,Death Wish,30000000,34017028,48575965,2018,3,61.92,18575965
29,2010-11-24,Love and Other Drugs,30000000,32367005,102716321,2010,11,242.39,72716321
30,2015-06-03,Entourage,30000000,32363404,46438538,2015,6,54.8,16438538
31,2001-06-01,What's the Worst That Could Happen?,30000000,32267774,38462071,2001,6,28.21,8462071
32,2013-02-08,Side Effects,30000000,32172757,66742138,2013,2,122.47,36742138
33,2009-09-09,9,30000000,31749894,48559999,2009,9,61.87,18559999
34,2014-07-02,Deliver Us from Evil,30000000,30577122,87956618,2014,7,193.19,57956618
35,2014-08-01,Get on Up,30000000,30569935,33339868,2014,8,11.13,3339868
36,2017-12-25,Mollyâs Game,30000000,28780744,53296424,2017,12,77.65,23296424
37,2012-04-27,The Five-Year Engagement,30000000,28700285,61623819,2012,4,105.41,31623819
38,2004-04-02,The Prince & Me,30000000,28165882,29356757,2004,4,-2.14,-643243
39,2011-07-15,Winnie the Pooh,30000000,26692846,50145607,2011,7,67.15,20145607
41,2003-06-13,Dumb and Dumberer: When Harry Met Lloyd,30000000,26214846,26214846,2003,6,-12.62,-3785154
42,2018-09-14,White Boy Rick,30000000,24004833,25947983,2018,9,-13.51,-4052017
45,2011-02-04,Sanctum,30000000,23209310,108957098,2011,2,263.19,78957098
46,2006-07-21,My Super Ex-Girlfriend,30000000,22530295,60772856,2006,7,102.58,30772856
47,2017-08-25,Ballerina,30000000,21858070,96892829,2017,8,222.98,66892829
48,2004-09-17,Mr. 3000,30000000,21800302,21827296,2004,9,-27.24,-8172704
49,2010-11-19,The Next Three Days,30000000,21148651,67255916,2010,11,124.19,37255916
50,2018-01-12,Proud Mary,30000000,20868638,21709539,2018,1,-27.63,-8290461
51,2004-08-06,Little Black Book,30000000,20422207,21758371,2004,8,-27.47,-8241629
52,2005-01-19,Assault On Precinct 13,30000000,20040895,36040895,2005,1,20.14,6040895
53,2013-10-04,Runner Runner,30000000,19316646,60512680,2013,10,101.71,30512680
55,2017-04-28,Baahubali 2: The Conclusion,30000000,18985794,263502914,2017,4,778.34,233502914
56,2006-03-03,Ultraviolet,30000000,18522064,30962112,2006,3,3.21,962112
57,2005-10-21,North Country,30000000,18324242,23676771,2005,10,-21.08,-6323229
58,2011-08-19,Fright Night,30000000,18298649,40520649,2011,8,35.07,10520649
59,2017-09-15,mother!,30000000,17800004,42531076,2017,9,41.77,12531076
60,2015-10-09,Steve Jobs,30000000,17766658,35579007,2015,10,18.6,5579007
61,2002-07-17,Eight Legged Freaks,30000000,17266505,36722311,2002,7,22.41,6722311
63,2010-06-04,Splice,30000000,17010170,28542494,2010,6,-4.86,-1457506
64,2008-04-18,88 Minutes,30000000,16930884,32955399,2008,4,9.85,2955399
65,2004-04-09,The Whole Ten Yards,30000000,16323969,26323969,2004,4,-12.25,-3676031
67,2008-10-24,Pride and Glory,30000000,15740721,43440721,2008,10,44.8,13440721
68,2005-08-26,The Cave,30000000,15007991,27147991,2005,8,-9.51,-2852009
69,2004-04-30,Godsend,30000000,14334645,16910708,2004,4,-43.63,-13089292
70,2003-06-20,Alex & Emma,30000000,14208384,15358583,2003,6,-48.8,-14641417
71,2004-09-03,Wicker Park,30000000,13001257,21577076,2004,9,-28.08,-8422924
72,2005-12-25,The New World,30000000,12712093,26184400,2005,12,-12.72,-3815600
73,2007-06-29,Evening,30000000,12406646,12885574,2007,6,-57.05,-17114426
74,2013-01-18,The Last Stand,30000000,12050299,48330757,2013,1,61.1,18330757
77,2001-01-12,Antitrust,30000000,10965209,17865209,2001,1,-40.45,-12134791
78,2013-03-08,Dead Man Down,30000000,10895295,19599974,2013,3,-34.67,-10400026
79,2011-04-29,Hoodwinked Too: Hood vs. Evil,30000000,10143779,23353111,2011,4,-22.16,-6646889
80,2009-04-10,Dragonball Evolution,30000000,9362785,58228460,2009,4,94.09,28228460
81,2004-09-24,First Daughter,30000000,9055010,10419084,2004,9,-65.27,-19580916
82,2017-04-14,The Lost City of Z,30000000,8574339,17121823,2017,4,-42.93,-12878177
83,2005-09-09,An Unfinished Life,30000000,8535575,18535575,2005,9,-38.21,-11464425
84,2017-02-03,The Space Between Us,30000000,7885294,16481405,2017,2,-45.06,-13518595
85,2009-12-25,The Imaginarium of Doctor Parnassus,30000000,7689607,64352607,2009,12,114.51,34352607
86,2011-01-14,Barney's Version,30000000,7502560,8845575,2011,1,-70.51,-21154425
87,2002-09-20,Trapped,30000000,6916869,6916869,2002,9,-76.94,-23083131
88,2018-08-31,Kin,30000000,5718096,10096821,2018,8,-66.34,-19903179
90,2017-09-22,Stronger,30000000,4211129,8786752,2017,9,-70.71,-21213248
92,2007-09-21,The Assassination of Jesse James by the Coward Robert Ford,30000000,3909149,15313631,2007,9,-48.95,-14686369
93,2004-12-29,The Merchant of Venice,30000000,3765585,18765585,2004,12,-37.45,-11234415
94,2003-04-02,The Good Thief,30000000,3517797,6460758,2003,4,-78.46,-23539242
95,2005-08-17,Supercross,30000000,3102550,3252550,2005,8,-89.16,-26747450
96,2006-12-29,Miss Potter,30000000,3005605,35891257,2006,12,19.64,5891257
97,2006-05-05,Wu ji,30000000,669625,35869934,2006,5,19.57,5869934
98,2019-06-14,Shaft,30000000,600000,600000,2019,6,-98.0,-29400000
99,2011-09-23,Machine Gun Preacher,30000000,538690,3721988,2011,9,-87.59,-26278012
100,2018-02-02,Bilal: A New Breed of Hero,30000000,490973,648599,2018,2,-97.84,-29351401
1,2007-06-15,DOA: Dead or Alive,30000000,480314,7755686,2007,6,-74.15,-22244314
2,2010-02-19,Le Petit Nicolas,30000000,201857,52339566,2010,2,74.47,22339566
3,2011-10-07,Xinhai geming,30000000,135739,8593154,2011,10,-71.36,-21406846
4,2008-02-21,Genghis Khan: To the Ends of the Earth and Sea,30000000,3892,4874498,2008,2,-83.75,-25125502
5,2015-01-30,Wild Card,30000000,3200,4315789,2015,1,-85.61,-25684211
6,2015-06-05,United Passions,30000000,918,168832,2015,6,-99.44,-29831168
7,2010-12-31,Konferenz der Tiere,30000000,0,53048539,2010,12,76.83,23048539
8,2015-12-01,Grace of Monaco,30000000,0,25199891,2015,12,-16.0,-4800109
9,2016-03-08,Savva. Serdtse voyna,30000000,0,5015080,2016,3,-83.28,-24984920
10,2007-12-14,Goodbye Bafana,30000000,0,2717302,2007,12,-90.94,-27282698
11,2013-12-31,Space Pirate Captain Harlock,30000000,0,310985,2013,12,-98.96,-29689015
13,2017-02-24,Collide,29200000,2280004,5466698,2017,2,-81.28,-23733302
14,2015-05-15,Pitch Perfect 2,29000000,184296230,287625468,2015,5,891.81,258625468
15,2005-11-18,Walk the Line,29000000,119519402,187707495,2005,11,547.27,158707495
16,2018-09-28,Night School,29000000,77339130,103008792,2018,9,255.2,74008792
17,2016-04-08,The Boss,29000000,63077560,78652207,2016,4,171.21,49652207
19,2003-09-12,Once Upon a Time in Mexico,29000000,56330657,97413527,2003,9,235.91,68413527
20,2000-04-14,Keeping the Faith,29000000,37036404,45336404,2000,4,56.33,16336404
21,2017-08-18,Logan Lucky,29000000,27778642,44264271,2017,8,52.64,15264271
22,2016-08-12,Florence Foster Jenkins,29000000,27383770,56000339,2016,8,93.1,27000339
24,2008-12-05,Frost/Nixon,29000000,18622031,28452945,2008,12,-1.89,-547055
25,2004-11-12,Seed of Chucky,29000000,17016190,24716190,2004,11,-14.77,-4283810
26,2002-08-23,Serving Sara,29000000,16930185,20146150,2002,8,-30.53,-8853850
27,2002-12-31,Confessions of a Dangerous Mind,29000000,16007718,33013805,2002,12,13.84,4013805
28,2009-08-26,Taking Woodstock,29000000,7460204,10066366,2009,8,-65.29,-18933634
32,2005-03-04,The Jacket,28500000,6301131,15452978,2005,3,-45.78,-13047022
35,2015-08-14,Straight Outta Compton,28000000,161197785,202182981,2015,8,622.08,174182981
36,2017-07-21,Girls Trip,28000000,115108515,140886353,2017,7,403.17,112886353
39,2001-04-06,Along Came a Spider,28000000,74058698,105159085,2001,4,275.57,77159085
40,2017-11-01,A Bad Moms Christmas,28000000,72110659,127710550,2017,11,356.11,99710550
41,2013-02-14,Safe Haven,28000000,71399120,94050951,2013,2,235.9,66050951
42,2015-12-11,The Big Short,28000000,70259870,133162752,2015,12,375.58,105162752
43,2008-11-07,Role Models,28000000,67300955,94500826,2008,11,237.5,66500826
44,2014-10-10,"Alexander and the Terrible, Horrible, No Good, Very Bad Day",28000000,66954149,101379287,2014,10,262.07,73379287
45,2004-02-06,Miracle,28000000,64378093,64474705,2004,2,130.27,36474705
46,2013-01-28,Last Vegas,28000000,63914167,112914167,2013,1,303.26,84914167
47,2001-01-26,The Wedding Planner,28000000,60400856,94728529,2001,1,238.32,66728529
48,2004-03-19,Dawn of the Dead,28000000,58990765,103452875,2004,3,269.47,75452875
50,2018-06-15,Tag,28000000,54730625,77026186,2018,6,175.09,49026186
51,2001-12-14,The Royal Tenenbaums,28000000,52353636,71430876,2001,12,155.11,43430876
52,2003-04-25,Identity,28000000,52131264,82183683,2003,4,193.51,54183683
53,2001-10-05,Serendipity,28000000,50255310,77477297,2001,10,176.7,49477297
54,2010-04-16,Kick-Ass,28000000,48071303,97531134,2010,4,248.33,69531134
55,2001-09-28,Zoolander,28000000,45172250,60780981,2001,9,117.07,32780981
57,2007-07-27,No Reservations,28000000,43107979,91943956,2007,7,228.37,63943956
59,2005-11-11,Pride & Prejudice,28000000,38372662,126549607,2005,11,351.96,98549607
60,2011-08-12,30 Minutes or Less,28000000,37053924,40966716,2011,8,46.31,12966716
61,2000-12-22,Dracula 2000,28000000,33000377,33000377,2000,12,17.86,5000377
64,2014-02-21,3 Days to Kill,28000000,30697999,38959900,2014,2,39.14,10959900
65,2013-08-16,Kick-Ass 2,28000000,28795985,63129909,2013,8,125.46,35129909
66,2007-10-12,We Own the Night,28000000,28563179,55307857,2007,10,97.53,27307857
67,2014-09-19,A Walk Among the Tombstones,28000000,26017685,62108587,2014,9,121.82,34108587
68,2010-01-15,The Spy Next Door,28000000,24307106,46752858,2010,1,66.97,18752858
69,2014-04-25,Brick Mansions,28000000,20396829,73421224,2014,4,162.22,45421224
70,2006-05-12,Just My Luck,28000000,17326650,38159905,2006,5,36.29,10159905
71,2000-10-13,Lost Souls,28000000,16779636,31320293,2000,10,11.86,3320293
72,2015-08-21,American Ultra,28000000,14439985,30295028,2015,8,8.2,2295028
73,2003-04-18,Winged Migration,28000000,11689053,39134983,2003,4,39.77,11134983
74,2016-02-05,Pride and Prejudice and Zombies,28000000,10907291,16638300,2016,2,-40.58,-11361700
76,2001-08-24,John Carpenterâs Ghosts of Mars,28000000,8434601,8434601,2001,8,-69.88,-19565399
78,2015-10-30,Our Brand is Crisis,28000000,7002261,8594558,2015,10,-69.31,-19405442
80,2008-10-03,How to Lose Friends & Alienate People,28000000,2775593,12031443,2008,10,-57.03,-15968557
81,2007-12-31,Alatriste,28000000,0,22860477,2007,12,-18.36,-5139523
82,2007-06-01,Knocked Up,27500000,148761765,219265952,2007,6,697.33,191765952
84,2009-06-26,My Sister's Keeper,27500000,49200230,96673002,2009,6,251.54,69173002
85,2008-02-08,Welcome Home Roscoe Jenkins,27500000,42436517,43607627,2008,2,58.57,16107627
86,2012-01-13,Joyful Noise,27500000,30932113,31157914,2012,1,13.3,3657914
88,2006-12-25,Notes on a Scandal,27500000,17510118,50578411,2006,12,83.92,23078411
89,2007-10-19,Rendition,27500000,9736045,26939925,2007,10,-2.04,-560075
90,2011-10-28,Anonymous,27500000,4463292,15815509,2011,10,-42.49,-11684491
91,2011-03-18,Limitless,27000000,79249455,155564919,2011,3,476.17,128564919
93,2002-06-07,The Divine Secrets of the Ya-Ya Sisterhood,27000000,69586544,73826768,2002,6,173.43,46826768
97,2008-08-06,The Sisterhood of the Traveling Pants 2,27000000,44089964,44270131,2008,8,63.96,17270131
98,2016-05-13,Money Monster,27000000,41012075,93466095,2016,5,246.17,66466095
99,2002-05-17,About a Boy,27000000,40803000,130759651,2002,5,384.3,103759651
100,2011-08-19,Spy Kids: All the Time in the World,27000000,38536376,80681183,2011,8,198.82,53681183
2,2006-04-07,Lucky Number Slevin,27000000,22495466,55495466,2006,4,105.54,28495466
6,2008-09-19,The Duchess,27000000,13848978,45160110,2008,9,67.26,18160110
7,2010-10-01,Case 39,27000000,13261851,28773827,2010,10,6.57,1773827
8,2005-06-10,The Honeymooners,27000000,12834849,13174426,2005,6,-51.21,-13825574
11,2004-08-27,Suspect Zero,27000000,8712564,8712564,2004,8,-67.73,-18287436
12,2007-11-02,Martian Child,27000000,7500310,9352089,2007,11,-65.36,-17647911
13,2002-10-18,Formula 51,27000000,5204007,5204007,2002,10,-80.73,-21795993
15,2005-05-13,Mindhunters,27000000,4476235,16566235,2005,5,-38.64,-10433765
16,2008-10-17,What Just Happened,27000000,1090947,2412123,2008,10,-91.07,-24587877
17,2003-12-12,The Statement,27000000,765637,1545064,2003,12,-94.28,-25454936
19,2016-11-23,Rules Donât Apply,26700000,3652206,3871448,2016,11,-85.5,-22828552
20,2009-01-16,Paul Blart: Mall Cop,26000000,146336178,185904750,2009,1,615.02,159904750
21,2003-08-06,Freaky Friday,26000000,110222438,160822438,2003,8,518.55,134822438
22,2005-08-19,The 40 Year-old Virgin,26000000,109449237,177344230,2005,8,582.09,151344230
25,2008-08-06,Pineapple Express,26000000,87341380,102404019,2008,8,293.86,76404019
29,2003-08-15,Open Range,26000000,58331254,68613992,2003,8,163.9,42613992
30,2005-08-19,Red Eye,26000000,57891803,96666486,2005,8,271.79,70666486
31,2011-12-09,New Yearâs Eve,26000000,54544638,146850273,2011,12,464.81,120850273
33,2013-04-26,Pain & Gain,26000000,49875291,81275291,2013,4,212.6,55275291
34,2003-01-31,Final Destination 2,26000000,46896664,90396664,2003,1,247.68,64396664
35,2000-12-22,"O Brother, Where Art Thou?",26000000,45506619,75763814,2000,12,191.4,49763814
36,2004-12-29,In Good Company,26000000,45489752,63489752,2004,12,144.19,37489752
37,2010-01-22,Legion,26000000,40168080,67647574,2010,1,160.18,41647574
38,2012-08-29,Lawless,26000000,37397291,54393687,2012,8,109.21,28393687
39,2002-03-29,Clockstoppers,26000000,36985501,38788828,2002,3,49.19,12788828
41,2009-12-04,Brothers,26000000,28544157,45043870,2009,12,73.25,19043870
42,2014-10-17,The Best of Me,26000000,26766213,41059418,2014,10,57.92,15059418
43,2004-03-12,Agent Cody Banks 2: Destination London,26000000,23514247,28703083,2004,3,10.4,2703083
44,2001-08-03,Original Sin,26000000,16521410,16521410,2001,8,-36.46,-9478590
45,2012-04-27,The Raven,26000000,16008272,30601801,2012,4,17.7,4601801
46,2004-02-20,Welcome to Mooseport,26000000,14469428,14469428,2004,2,-44.35,-11530572
48,2015-07-10,Self/Less,26000000,12279691,33667319,2015,7,29.49,7667319
49,2001-08-24,The Curse of the Jade Scorpion,26000000,7496522,18496522,2001,8,-28.86,-7503478
50,2013-10-18,The Fifth Estate,26000000,3254172,6154172,2013,10,-76.33,-19845828
52,2014-03-21,Blood Ties,26000000,42472,2923959,2014,3,-88.75,-23076041
54,2015-06-30,Viy,26000000,0,34246770,2015,6,31.72,8246770
55,2015-03-17,Accidental Love,26000000,0,135436,2015,3,-99.48,-25864564
58,2005-08-31,The Constant Gardener,25500000,33579798,86301599,2005,8,238.44,60801599
59,2008-10-17,W.,25100000,25534493,28575778,2008,10,13.85,3475778
60,2004-02-25,The Passion of the Christ,25000000,370782930,622341924,2004,2,2389.37,597341924
63,2011-08-10,The Help,25000000,169705587,213120004,2011,8,752.48,188120004
64,2016-12-25,Hidden Figures,25000000,169607287,231771716,2016,12,827.09,206771716
65,2008-12-12,Gran Torino,25000000,148095302,274543085,2008,12,998.17,249543085
66,2009-01-30,Taken,25000000,145000989,226941585,2009,1,807.77,201941585
67,2014-01-17,Ride Along,25000000,134202565,153733800,2014,1,514.94,128733800
70,2003-07-02,"Legally Blonde 2: Red, White & Blonde",25000000,90639088,125339088,2003,7,401.36,100339088
71,2004-03-26,Scooby-Doo 2: Monsters Unleashed,25000000,84185387,181185387,2004,3,624.74,156185387
72,2004-07-09,Anchorman: The Legend of Ron Burgundy,25000000,84136909,89476265,2004,7,257.91,64476265
73,2003-08-15,Freddy vs. Jason,25000000,82622655,114576403,2003,8,358.31,89576403
74,2007-02-16,Bridge to Terabithia,25000000,82234139,137984788,2007,2,451.94,112984788
75,2001-12-21,Jimmy Neutron: Boy Genius,25000000,80936232,102992536,2001,12,311.97,77992536
76,2008-01-18,Cloverfield,25000000,80048433,171302226,2008,1,585.21,146302226
77,2010-02-05,Dear John,25000000,80014842,142033509,2010,2,468.13,117033509
79,2012-12-25,Parental Guidance,25000000,77267296,120832383,2012,12,383.33,95832383
81,2007-11-09,No Country for Old Men,25000000,74273505,164035753,2007,11,556.14,139035753
82,2001-04-13,Bridget Jones's Diary,25000000,71500556,281527158,2001,4,1026.11,256527158
83,2000-12-15,Chocolat,25000000,71309760,152500343,2000,12,510.0,127500343
84,2011-01-21,No Strings Attached,25000000,70662220,149228078,2011,1,496.91,124228078
85,2012-01-13,Contraband,25000000,66528000,98406855,2012,1,293.63,73406855
86,2017-01-27,A Dogâs Purpose,25000000,64321890,203671625,2017,1,714.69,178671625
87,2012-04-20,The Lucky One,25000000,60457138,96633833,2012,4,286.54,71633833
89,2000-03-22,Romeo Must Die,25000000,55973336,91036760,2000,3,264.15,66036760
90,2006-06-06,The Omen,25000000,54607383,119295584,2006,6,377.18,94295584
91,2006-02-10,Final Destination 3,25000000,54098051,112798051,2006,2,351.19,87798051
92,2011-04-22,Madea's Big Happy Family,25000000,53345287,54160818,2011,4,116.64,29160818
93,2013-12-13,Tyler Perry's A Madea Christmas,25000000,52543354,52543354,2013,12,110.17,27543354
94,2004-11-12,Finding Neverland,25000000,51676606,115036108,2004,11,360.14,90036108
95,2012-01-27,The Grey,25000000,51580136,81249176,2012,1,225.0,56249176
96,2005-01-28,Hide and Seek,25000000,51100486,123696741,2005,1,394.79,98696741
98,2008-08-22,The House Bunny,25000000,48237389,71390601,2008,8,185.56,46390601
99,2003-03-14,Agent Cody Banks,25000000,47545060,58240458,2003,3,132.96,33240458
100,2006-01-27,Nanny McPhee,25000000,47279279,128745578,2006,1,414.98,103745578
2,2014-08-15,The Giver,25000000,45090374,66540205,2014,8,166.16,41540205
6,2015-11-20,The Night Before,25000000,43035725,52427346,2015,11,109.71,27427346
8,2002-12-27,The Hours,25000000,41675994,97030468,2002,12,288.12,72030468
10,2007-12-26,There Will Be Blood,25000000,40222514,77208711,2007,12,208.83,52208711
11,2002-12-20,The Wild Thornberrys Movie,25000000,40108697,60694737,2002,12,142.78,35694737
12,2003-06-13,Rugrats Go Wild,25000000,39402572,55443032,2003,6,121.77,30443032
13,2005-06-01,The Sisterhood of the Traveling Pants,25000000,39053061,41560117,2005,6,66.24,16560117
14,2002-05-31,Undercover Brother,25000000,38230435,40796145,2002,5,63.18,15796145
15,2013-12-25,August: Osage County,25000000,37738810,50738810,2013,12,102.96,25738810
16,2001-07-06,Kiss of the Dragon,25000000,36833473,36833473,2001,7,47.33,11833473
17,2014-05-16,Million Dollar Arm,25000000,36447959,39217912,2014,5,56.87,14217912
18,2004-01-01,Beauty Shop,25000000,36351350,38351350,2004,1,53.41,13351350
19,2003-04-04,What a Girl Wants,25000000,35990505,35990505,2003,4,43.96,10990505
20,2003-08-29,Jeepers Creepers II,25000000,35623801,119923801,2003,8,379.7,94923801
21,2018-09-07,Peppermint,25000000,35418723,51800758,2018,9,107.2,26800758
22,2007-09-21,Good Luck Chuck,25000000,35017297,59183821,2007,9,136.74,34183821
23,2003-02-28,Cradle 2 the Grave,25000000,34657731,56434942,2003,2,125.74,31434942
24,2006-03-17,She's the Man,25000000,33889159,55279608,2006,3,121.12,30279608
25,2014-12-10,The Gambler,25000000,33680992,38718031,2014,12,54.87,13718031
26,2007-08-24,Mr. Beanâs Holiday,25000000,33302167,234981342,2007,8,839.93,209981342
27,2016-04-29,Motherâs Day,25000000,32492859,52367022,2016,4,109.47,27367022
29,2017-02-17,Fist Fight,25000000,32187017,40286416,2017,2,61.15,15286416
30,2007-11-21,August Rush,25000000,31664162,65882103,2007,11,163.53,40882103
31,2004-08-27,Anacondas: The Hunt for the Blood Orchid,25000000,31526393,70326393,2004,8,181.31,45326393
32,2011-12-09,The Sitter,25000000,30542576,38749404,2011,12,55.0,13749404
36,2014-04-11,Draft Day,25000000,28842237,29847480,2014,4,19.39,4847480
38,2017-02-03,Rings,25000000,27793018,82917283,2017,2,231.67,57917283
39,2009-05-22,Dance Flick,25000000,25794018,32224624,2009,5,28.9,7224624
40,2001-04-20,Crocodile Dundee in Los Angeles,25000000,25590119,39393111,2001,4,57.57,14393111
42,2005-03-18,Ice Princess,25000000,24381334,25732334,2005,3,2.93,732334
43,2011-08-26,Don't Be Afraid of the Dark,25000000,24046682,39126427,2011,8,56.51,14126427
44,2010-04-23,The Losers,25000000,23591432,29863840,2010,4,19.46,4863840
45,2009-04-24,Fighting,25000000,23091010,32831707,2009,4,31.33,7831707
46,2007-08-24,War,25000000,22486409,40686409,2007,8,62.75,15686409
48,2005-04-22,A Lot Like Love,25000000,21835784,41921590,2005,4,67.69,16921590
50,2011-02-11,The Eagle,25000000,19490041,38993548,2011,2,55.97,13993548
51,2015-08-05,Shaun the Sheep,25000000,19375982,101925161,2015,8,307.7,76925161
52,2011-09-02,Shark Night 3D,25000000,18877153,18877153,2011,9,-24.49,-6122847
53,2017-03-24,CHiPS,25000000,18600152,23190292,2017,3,-7.24,-1809708
54,2002-10-11,Punch-Drunk Love,25000000,17791031,24591031,2002,10,-1.64,-408969
55,2004-02-20,Eurotrip,25000000,17718223,20718223,2004,2,-17.13,-4281777
56,2017-12-22,Father Figures,25000000,17501244,21038441,2017,12,-15.85,-3961559
57,2008-04-04,The Ruins,25000000,17432844,22910563,2008,4,-8.36,-2089437
58,2013-10-25,The Counselor,25000000,16973715,71009334,2013,10,184.04,46009334
59,2006-12-08,Unaccompanied Minors,25000000,16655224,21970831,2006,12,-12.12,-3029169
60,2018-12-07,Mary Queen of Scots,25000000,16468499,46734733,2018,12,86.94,21734733
62,2002-11-15,Half Past Dead,25000000,15567860,19233280,2002,11,-23.07,-5766720
65,2005-09-30,The Greatest Game Ever Played,25000000,15331289,15468266,2005,9,-38.13,-9531734
66,2009-11-06,The Box,25000000,15051977,34356760,2009,11,37.43,9356760
67,2000-03-03,The Next Best Thing,25000000,14983572,24355762,2000,3,-2.58,-644238
68,2010-10-08,My Soul to Take,25000000,14744435,16727470,2010,10,-33.09,-8272530
69,2004-04-09,The Girl Next Door,25000000,14589444,31635150,2004,4,26.54,6635150
70,2008-08-15,Fly Me To the Moon,25000000,14543943,43530281,2008,8,74.12,18530281
72,2002-09-13,Stealing Harvard,25000000,13973532,13973532,2002,9,-44.11,-11026468
73,2007-08-03,Hot Rod,25000000,13938332,14334401,2007,8,-42.66,-10665599
74,2011-09-09,Warrior,25000000,13657115,24215385,2011,9,-3.14,-784615
76,2017-09-22,Battle of the Sexes,25000000,12638526,18445379,2017,9,-26.22,-6554621
77,2012-12-21,Cirque du Soleil: Worlds Away,25000000,12512862,28012862,2012,12,12.05,3012862
78,2015-11-13,The 33,25000000,12227722,28400715,2015,11,13.6,3400715
80,2011-04-15,The Conspirator,25000000,11538204,15907411,2011,4,-36.37,-9092589
81,2002-07-03,The Powerpuff Girls,25000000,11411644,16425701,2002,7,-34.3,-8574299
82,2005-06-03,The Lords of Dogtown,25000000,11273517,13424365,2005,6,-46.3,-11575635
85,2008-03-28,Stop-Loss,25000000,10915744,11229035,2008,3,-55.08,-13770965
87,2002-10-18,Abandon,25000000,10719367,12219367,2002,10,-51.12,-12780633
88,2011-09-16,Straw Dogs,25000000,10324441,11253821,2011,9,-54.98,-13746179
90,2002-08-16,Possession,25000000,10103647,14805812,2002,8,-40.78,-10194188
93,2019-01-25,Serenity,25000000,8547045,11367029,2019,1,-54.53,-13632971
94,2009-11-25,The Road,25000000,8114270,29206732,2009,11,16.83,4206732
95,2018-10-12,Beautiful Boy,25000000,7634767,13031424,2018,10,-47.87,-11968576
96,2007-04-06,The Hoax,25000000,7164995,7164995,2007,4,-71.34,-17835005
97,2019-03-15,Captive State,25000000,5958315,8993300,2019,3,-64.03,-16006700
99,2005-09-02,Underclassman,25000000,5654777,5654777,2005,9,-77.38,-19345223
100,2001-03-23,Say It Isn't So,25000000,5516708,5516708,2001,3,-77.93,-19483292
1,2005-12-07,The World's Fastest Indian,25000000,5128124,18991288,2005,12,-24.03,-6008712
2,2008-04-25,Deception,25000000,4598506,12850033,2008,4,-48.6,-12149967
4,2005-04-22,King's Ransom,25000000,4008527,4049527,2005,4,-83.8,-20950473
5,2008-10-03,Blindness,25000000,3073392,20052958,2008,10,-19.79,-4947042
6,2018-04-13,Sgt. Stubby: An American Hero,25000000,3054285,3645957,2018,4,-85.42,-21354043
7,2011-12-16,Carnage,25000000,2546747,38112154,2011,12,52.45,13112154
8,2017-09-01,Tulip Fever,25000000,2455635,6792768,2017,9,-72.83,-18207232
9,2006-01-06,BloodRayne,25000000,2405420,3711633,2006,1,-85.15,-21288367
10,2015-11-20,Legend,25000000,1872994,42425450,2015,11,69.7,17425450
11,2009-11-20,Bad Lieutenant: Port of Call New Orleans,25000000,1702112,12413949,2009,11,-50.34,-12586051
12,2016-01-29,Jane Got a Gun,25000000,1513793,3771345,2016,1,-84.91,-21228655
13,2009-11-25,Me and Orson Welles,25000000,1190003,1190003,2009,11,-95.24,-23809997
14,2005-09-16,Venom,25000000,881745,881745,2005,9,-96.47,-24118255
15,2005-10-14,Where the Truth Lies,25000000,872142,1415656,2005,10,-94.34,-23584344
17,2013-03-22,On the Road,25000000,720828,9313302,2013,3,-62.75,-15686698
18,2012-08-24,Les petits mouchoirs,25000000,205505,48530887,2012,8,94.12,23530887
19,2010-06-30,Love Ranch,25000000,137885,146149,2010,6,-99.42,-24853851
20,2015-04-24,Yi ge ren de wu lin,25000000,129115,129115,2015,4,-99.48,-24870885
21,2010-12-31,Sammy's avonturen: De geheime doorgang,25000000,0,71594792,2010,12,186.38,46594792
22,2010-12-31,Belka i Strelka. Zvezdnye sobaki,25000000,0,9445081,2010,12,-62.22,-15554919
23,2017-12-31,Matilda,25000000,0,9370285,2017,12,-62.52,-15629715
24,2011-10-04,La vÃ©ritable histoire du Chat BottÃ©,25000000,0,8208594,2011,10,-67.17,-16791406
25,2011-07-08,Ironclad,25000000,0,5297411,2011,7,-78.81,-19702589
26,2019-05-10,The Professor and the Madman,25000000,0,5227233,2019,5,-79.09,-19772767
27,2015-03-10,Red Sky,25000000,0,91116,2015,3,-99.64,-24908884
31,2012-11-09,Dangerous Liaisons,24200000,17000,10447579,2012,11,-56.83,-13752421
34,2003-02-21,Old School,24000000,75155000,86765463,2003,2,261.52,62765463
35,2006-12-20,Rocky Balboa,24000000,70269899,156229050,2006,12,550.95,132229050
36,2014-06-20,Think Like a Man Too,24000000,65028687,70027933,2014,6,191.78,46027933
37,2016-12-16,Fences,24000000,57682904,64282881,2016,12,167.85,40282881
38,2000-02-18,The Whole Nine Yards,24000000,57262492,85527867,2000,2,256.37,61527867
39,2011-10-14,Footloose,24000000,51802742,62989834,2011,10,162.46,38989834
40,2017-04-07,Going in Style,24000000,45018541,78672579,2017,4,227.8,54672579
44,2007-11-21,Hitman,24000000,39687694,99135571,2007,11,313.06,75135571
46,2000-04-07,Return to Me,24000000,32662299,32662299,2000,4,36.09,8662299
47,2009-11-06,The Men Who Stare at Goats,24000000,32428195,67348218,2009,11,180.62,43348218
48,2008-10-31,Zack and Miri Make a Porno,24000000,31457946,36856306,2008,10,53.57,12856306
49,2001-01-12,Double Take,24000000,29823162,29823162,2001,1,24.26,5823162
51,2000-09-08,Nurse Betty,24000000,25170054,27732366,2000,9,15.55,3732366
52,2010-08-20,Piranha 3D,24000000,25003155,83660160,2010,8,248.58,59660160
53,2010-11-24,Faster,24000000,23240020,35792945,2010,11,49.14,11792945
55,2004-01-23,Win a Date with Tad Hamilton!,24000000,16980098,16980098,2004,1,-29.25,-7019902
57,2000-04-07,Ready to Rumble,24000000,12372410,12372410,2000,4,-48.45,-11627590
58,2011-09-16,I Don't Know How She Does It,24000000,9659074,24474463,2011,9,1.98,474463
60,2013-12-20,Dhoom 3,24000000,8031955,11723620,2013,12,-51.15,-12276380
61,2004-12-17,Beyond the Sea,24000000,6144806,8292914,2004,12,-65.45,-15707086
62,2005-06-10,Hauru no ugoku shiro,24000000,4710455,237814327,2005,6,890.89,213814327
65,2005-06-10,The Bridge of San Luis Rey,24000000,49981,1696765,2005,6,-92.93,-22303235
66,2007-12-31,Flood,24000000,0,4084232,2007,12,-82.98,-19915768
67,2009-10-02,Zombieland,23600000,75590286,102236596,2009,10,333.21,78636596
71,2018-11-16,Green Book,23000000,85080171,322034439,2018,11,1300.15,299034439
73,2015-01-16,The Wedding Ringer,23000000,64460211,80171596,2015,1,248.57,57171596
74,2000-03-17,Final Destination,23000000,53302314,112036870,2000,3,387.12,89036870
76,2011-10-07,The Ides of March,23000000,40962534,77735925,2011,10,237.98,54735925
77,2000-02-18,Pitch Black,23000000,39235088,53182088,2000,2,131.23,30182088
78,2018-10-05,The Hate U Give,23000000,29719483,35067665,2018,10,52.47,12067665
79,2001-03-30,Someone Like You,23000000,27338033,38684906,2001,3,68.2,15684906
80,2014-01-10,Her,23000000,25568251,48163815,2014,1,109.41,25163815
81,2001-10-05,Joy Ride,23000000,21973182,21973182,2001,10,-4.46,-1026818
82,2012-02-17,Kari gurashi no Arietti,23000000,19192510,151496097,2012,2,558.68,128496097
83,2012-01-20,Haywire,23000000,18942396,36374700,2012,1,58.15,13374700
85,2004-09-01,Vanity Fair,23000000,16123851,19123851,2004,9,-16.85,-3876149
86,2016-02-26,Eddie the Eagle,23000000,15789389,45060480,2016,2,95.92,22060480
88,2000-08-25,The Crew,23000000,13019253,13019253,2000,8,-43.39,-9980747
90,2004-01-09,Chasing Liberty,23000000,12189514,12291975,2004,1,-46.56,-10708025
91,2008-08-22,The Longshots,23000000,11511323,11778396,2008,8,-48.79,-11221604
94,2007-09-14,In the Valley of Elah,23000000,6777741,24489150,2007,9,6.47,1489150
95,2009-09-25,Coco avant Chanel,23000000,6113834,50813834,2009,9,120.93,27813834
96,2009-06-26,ChÃ©ri,23000000,2715657,2715657,2009,6,-88.19,-20284343
97,2013-06-28,Redemption,23000000,36686,13593473,2013,6,-40.9,-9406527
98,2008-04-25,Rogue,23000000,10452,4673377,2008,4,-79.68,-18326623
99,2017-05-05,ChÄi dÃ n zhuÄnjiÄ,23000000,0,58807172,2017,5,155.68,35807172
100,2011-03-15,Shi Yue Wei Cheng,23000000,0,44195779,2011,3,92.16,21195779
2,2007-06-22,1408,22500000,71985628,131263370,2007,6,483.39,108763370
3,2016-11-18,Nocturnal Animals,22500000,10663357,32398681,2016,11,43.99,9898681
4,2015-04-24,The Water Diviner,22500000,4200117,31054727,2015,4,38.02,8554727
8,2007-09-28,The Game Plan,22000000,90648202,146590987,2007,9,566.32,124590987
9,2002-03-29,The Rookie,22000000,75600072,80491516,2002,3,265.87,58491516
11,2014-02-28,Son of God,22000000,59700064,70949793,2014,2,222.5,48949793
12,2001-06-01,The Animal,22000000,55762229,55762229,2001,6,153.46,33762229
13,2014-08-08,The Hundred-Foot Journey,22000000,54235441,94270488,2014,8,328.5,72270488
15,2003-09-19,Underworld,22000000,51970690,95708457,2003,9,335.04,73708457
17,2012-08-03,Diary of a Wimpy Kid: Dog Days,22000000,49008662,77229695,2012,8,251.04,55229695
18,2001-12-28,I Am Sam,22000000,40270895,92542418,2001,12,320.65,70542418
19,2005-11-11,Derailed,22000000,36020063,57520063,2005,11,161.45,35520063
20,2009-09-18,The Informant!,22000000,33316821,41771168,2009,9,89.87,19771168
21,2013-11-22,Delivery Man,22000000,30659817,70536870,2013,11,220.62,48536870
22,2016-02-05,"Hail, Caesar!",22000000,30080225,64160680,2016,2,191.64,42160680
23,2001-08-24,Jay and Silent Bob Strike Back,22000000,30059386,33762400,2001,8,53.47,11762400
25,2008-08-27,Traitor,22000000,23530831,27882226,2008,8,26.74,5882226
26,2005-08-12,Deuce Bigalow: European Gigolo,22000000,22400154,45273464,2005,8,105.79,23273464
27,2017-05-19,Diary of a Wimpy Kid: The Long Haul,22000000,20738724,35609577,2017,5,61.86,13609577
28,2008-01-18,Mad Money,22000000,20668843,25044057,2008,1,13.84,3044057
29,2013-11-27,Homefront,22000000,20158492,51695362,2013,11,134.98,29695362
30,2008-09-19,Igor,22000000,19528602,31013349,2008,9,40.97,9013349
31,2001-02-09,Saving Silverman,22000000,19351569,25873142,2001,2,17.61,3873142
33,2001-09-14,The Glass House,22000000,17951431,22861785,2001,9,3.92,861785
34,2015-09-04,The Transporter Refueled,22000000,16029670,69698495,2015,9,216.81,47698495
36,2001-04-11,Josie and the Pussycats,22000000,14252830,14252830,2001,4,-35.21,-7747170
37,2012-08-22,Hit & Run,22000000,13749300,17216955,2012,8,-21.74,-4783045
38,2000-10-27,The Little Vampire,22000000,13555988,13555988,2000,10,-38.38,-8444012
39,2004-10-01,I Heart Huckabees,22000000,12784713,20034713,2004,10,-8.93,-1965287
40,2017-11-17,"Roman J. Israel, Esq.",22000000,11962712,12967012,2017,11,-41.06,-9032988
41,2013-12-04,Out of the Furnace,22000000,11330849,15434375,2013,12,-29.84,-6565625
44,2017-12-08,Just Getting Started,22000000,6069605,6756412,2017,12,-69.29,-15243588
45,2001-09-21,Megiddo: Omega Code 2,22000000,6047691,6047691,2001,9,-72.51,-15952309
47,2005-11-23,The Libertine,22000000,4835065,9448623,2005,11,-57.05,-12551377
48,2007-04-06,Zwartboek,22000000,4398532,27238354,2007,4,23.81,5238354
49,2014-10-31,Before I Go to Sleep,22000000,3242457,19563579,2014,10,-11.07,-2436421
50,2010-10-08,Stone,22000000,1810078,4065020,2010,10,-81.52,-17934980
51,2006-03-03,Joyeux NoÃ«l,22000000,1054361,23134075,2006,3,5.15,1134075
52,2013-12-31,Metegol,22000000,0,34061097,2013,12,54.82,12061097
54,2007-07-27,MoliÃ¨re,21600000,635733,791154,2007,7,-96.34,-20808846
55,2007-10-05,Michael Clayton,21500000,49033882,92987651,2007,10,332.5,71487651
58,2012-06-22,To Rome with Love,21500000,16684352,74326015,2012,6,245.7,52826015
59,2012-11-16,Silver Linings Playbook,21000000,132092958,236412453,2012,11,1025.77,215412453
60,2018-04-06,Blockers,21000000,60311495,94045328,2018,4,347.83,73045328
61,2019-04-05,Pet Sematary,21000000,54724696,109501146,2019,4,421.43,88501146
64,2010-04-16,Death at a Funeral,21000000,42739347,48977233,2010,4,133.22,27977233
66,2001-09-14,Hardball,21000000,40222729,43728560,2001,9,108.23,22728560
67,2010-11-05,For Colored Girls,21000000,37729698,38017873,2010,11,81.04,17017873
68,2007-01-05,Freedom Writers,21000000,36605602,43632609,2007,1,107.77,22632609
69,2017-08-04,Kidnap,21000000,30718107,34836080,2017,8,65.89,13836080
70,2002-10-11,The Transporter,21000000,25296447,43928932,2002,10,109.19,22928932
71,2008-03-14,Never Back Down,21000000,24850922,39319801,2008,3,87.24,18319801
72,2011-12-09,Tinker Tailor Soldier Spy,21000000,24149393,81452811,2011,12,287.87,60452811
73,2017-09-22,Victoria and Abdul,21000000,22245070,68271146,2017,9,225.1,47271146
76,2008-08-01,Swing Vote,21000000,16289867,17589867,2008,8,-16.24,-3410133
77,2009-06-05,Away We Go,21000000,9451946,10108016,2009,6,-51.87,-10891984
78,2002-09-27,Moonlight Mile,21000000,6830957,6830957,2002,9,-67.47,-14169043
79,2011-05-06,The Beaver,21000000,970816,5046038,2011,5,-75.97,-15953962
80,2017-02-24,Bitter Harvest,21000000,557241,606162,2017,2,-97.11,-20393838
85,2006-08-11,Pulse,20500000,20264436,30241435,2006,8,47.52,9741435
88,2019-03-22,Us,20000000,175006930,254210310,2019,3,1171.05,234210310
92,2016-12-09,La La Land,20000000,151101803,426351163,2016,12,2031.76,406351163
93,2013-07-19,The Conjuring,20000000,137400141,318000141,2013,7,1490.0,298000141
94,2003-03-07,Bringing Down the House,20000000,132675402,164675402,2003,3,723.38,144675402
95,2017-11-17,Wonder,20000000,132422809,304604712,2017,11,1423.02,284604712
98,2010-10-15,Jackass 3D,20000000,117229692,171685793,2010,10,758.43,151685793
99,2016-07-29,Bad Moms,20000000,113257297,180998716,2016,7,804.99,160998716
100,2019-01-18,Glass,20000000,111035005,245303505,2019,1,1126.52,225303505
2,2008-10-03,Beverly Hills Chihuahua,20000000,94514402,154218168,2008,10,671.09,134218168
3,2014-07-02,Tammy,20000000,84525432,96407655,2014,7,382.04,76407655
4,2005-01-21,Are We There Yet?,20000000,82674398,98114471,2005,1,390.57,78114471
5,2011-11-16,The Descendants,20000000,82624961,175507800,2011,11,777.54,155507800
6,2003-10-03,School of Rock,20000000,81261177,131944672,2003,10,559.72,111944672
7,2007-04-13,Disturbia,20000000,80818974,118537627,2007,4,492.69,98537627
9,2016-10-21,Tyler Perryâs Boo! A Madea Halloween,20000000,73206343,73206343,2016,10,266.03,53206343
11,2004-06-23,White Chicks,20000000,69148997,111448997,2004,6,457.24,91448997
12,2009-04-24,Obsessed,20000000,68261644,73964713,2009,4,269.82,53964713
13,2003-04-18,Holes,20000000,67383924,71232214,2003,4,256.16,51232214
14,2012-06-29,Tyler Perry's Madea's Witness Protection,20000000,65653242,66950887,2012,6,234.75,46950887
15,2010-03-31,The Last Song,20000000,62950384,92678948,2010,3,363.39,72678948
16,2010-04-02,Why Did I Get Married Too?,20000000,60095852,60831067,2010,4,204.16,40831067
18,2013-10-18,12 Years a Slave,20000000,56671993,181025343,2013,10,805.13,161025343
19,2002-12-13,Drumline,20000000,56398162,56398162,2002,12,181.99,36398162
20,2016-06-03,Me Before You,20000000,56245075,208265198,2016,6,941.33,188265198
21,2019-02-08,What Men Want,20000000,54611903,69911903,2019,2,249.56,49911903
22,2016-04-15,Barbershop: The Next Cut,20000000,54030051,54404202,2016,4,172.02,34404202
24,2018-09-14,A Simple Favor,20000000,53548586,97628717,2018,9,388.14,77628717
25,2015-01-09,Selma,20000000,52076908,66776576,2015,1,233.88,46776576
27,2006-02-17,Date Movie,20000000,48548426,85146165,2006,2,325.73,65146165
28,2002-02-15,Peter Pan: Return to Neverland,20000000,48430258,109862682,2002,2,449.31,89862682
29,2003-02-14,The Jungle Book 2,20000000,47901582,140122225,2003,2,600.61,120122225
30,2007-03-16,Premonition,20000000,47852604,81461343,2007,3,307.31,61461343
31,2017-10-20,Tyler Perryâs Boo 2! A Madea Halloween,20000000,47319572,47879572,2017,10,139.4,27879572
32,2005-02-04,Boogeyman,20000000,46752382,67192859,2005,2,235.96,47192859
33,2000-02-11,The Tigger Movie,20000000,45542421,96147688,2000,2,380.74,76147688
34,2015-11-06,Spotlight,20000000,45055776,92088460,2015,11,360.44,72088460
35,2018-03-30,Acrimony,20000000,43549096,46627836,2018,3,133.14,26627836
36,2015-06-26,Max,20000000,42656255,43658157,2015,6,118.29,23658157
37,2008-03-21,Meet the Browns,20000000,41975388,41975388,2008,3,109.88,21975388
38,2009-07-24,Orphan,20000000,41596251,78769428,2009,7,293.85,58769428
39,2017-11-17,The Star,20000000,40847995,62758010,2017,11,213.79,42758010
40,2007-01-26,Epic Movie,20000000,39739367,86858578,2007,1,334.29,66858578
41,2008-09-19,Lakeview Terrace,20000000,39263506,44821299,2008,9,124.11,24821299
42,2006-10-13,The Grudge 2,20000000,39143839,70743839,2006,10,253.72,50743839
43,2016-07-27,Nerve,20000000,38583626,70652284,2016,7,253.26,50652284
47,2006-10-13,Man of the Year,20000000,37442180,41342180,2006,10,106.71,21342180
48,2016-02-19,Risen,20000000,36880033,46255763,2016,2,131.28,26255763
49,2010-08-18,Vampires Suck,20000000,36661504,81424988,2010,8,307.12,61424988
51,2010-09-01,The American,20000000,35606376,67950723,2010,9,239.75,47950723
53,2011-11-04,A Very Harold & Kumar 3D Christmas,20000000,35061031,36265745,2011,11,81.33,16265745
54,2004-03-19,Eternal Sunshine of the Spotless Mind,20000000,34366518,72570762,2004,3,262.85,52570762
55,2013-01-04,Texas Chainsaw 3D,20000000,34341945,47666013,2013,1,138.33,27666013
56,2006-10-27,Babel,20000000,34302837,132121212,2006,10,560.61,112121212
57,2014-09-19,This is Where I Leave You,20000000,34296320,41296320,2014,9,106.48,21296320
58,2008-12-12,Doubt,20000000,33446470,53191101,2008,12,165.96,33191101
59,2004-10-15,Team America: World Police,20000000,32774834,50948811,2004,10,154.74,30948811
61,2013-04-12,Scary Movie V,20000000,32015787,78613981,2013,4,293.07,58613981
62,2010-03-12,She's Out of My League,20000000,32010860,48680977,2010,3,143.4,28680977
63,2008-11-26,Milk,20000000,31841299,57293371,2008,11,186.47,37293371
65,2011-08-31,The Debt,20000000,31177548,46604054,2011,8,133.02,26604054
66,2002-10-25,Ghost Ship,20000000,30113491,68349884,2002,10,241.75,48349884
67,2010-01-08,Daybreakers,20000000,30101577,51445503,2010,1,157.23,31445503
68,2008-03-07,The Bank Job,20000000,30060660,66143005,2008,3,230.72,46143005
70,2009-10-16,The Stepfather,20000000,29062561,29227561,2009,10,46.14,9227561
71,2000-03-31,High Fidelity,20000000,27277055,47881663,2000,3,139.41,27881663
72,2006-04-28,Stick It,20000000,26910736,30399714,2006,4,52.0,10399714
73,2008-01-04,One Missed Call,20000000,26890041,44513466,2008,1,122.57,24513466
75,2008-04-11,Street Kings,20000000,26418667,65457811,2008,4,227.29,45457811
76,2013-08-23,The World's End,20000000,26004851,47508505,2013,8,137.54,27508505
78,2010-09-24,You Again,20000000,25702053,32838945,2010,9,64.19,12838945
79,2007-06-15,Nancy Drew,20000000,25584685,30703845,2007,6,53.52,10703845
80,2010-09-17,Alpha and Omega 3D,20000000,25107267,48958353,2010,9,144.79,28958353
81,2018-12-25,On the Basis of Sex,20000000,24622687,38073377,2018,12,90.37,18073377
82,2014-02-14,Endless Love,20000000,23438250,34718173,2014,2,73.59,14718173
83,2006-09-08,The Covenant,20000000,23364784,38164784,2006,9,90.82,18164784
84,2011-07-01,Monte Carlo,20000000,23186769,39686769,2011,7,98.43,19686769
85,2006-03-24,Stay Alive,20000000,23086480,23187506,2006,3,15.94,3187506
86,2005-10-07,2 For the Money,20000000,22991379,30491379,2005,10,52.46,10491379
87,2017-06-16,Rough Night,20000000,22105643,46844357,2017,6,134.22,26844357
91,2009-08-21,Shorts,20000000,20919166,29870801,2009,8,49.35,9870801
93,2008-09-19,Appaloosa,20000000,20211394,27911453,2008,9,39.56,7911453
94,2015-11-20,Secret in Their Eyes,20000000,20180155,32608019,2015,11,63.04,12608019
95,2004-08-13,Yu-Gi-Oh,20000000,19762690,28762690,2004,8,43.81,8762690
96,2007-03-23,Reign Over Me,20000000,19661987,20081987,2007,3,0.41,81987
97,2008-09-19,My Best Friend's Girl,20000000,19219250,34787111,2008,9,73.94,14787111
98,2007-05-11,Georgia Rule,20000000,18882880,20819601,2007,5,4.1,819601
1,2007-09-21,Into the Wild,20000000,18354356,56822960,2007,9,184.11,36822960
3,2005-02-11,Pooh's Heffalump Movie,20000000,18098433,55686944,2005,2,178.43,35686944
4,2006-09-29,School for Scoundrels,20000000,17807569,17807569,2006,9,-10.96,-2192431
5,2012-10-26,Silent Hill: Revelation 3D,20000000,17530219,55975672,2012,10,179.88,35975672
7,2017-03-31,The Zookeeperâs Wife,20000000,17445186,26308749,2017,3,31.54,6308749
8,2009-02-20,Fired Up,20000000,17231291,18608570,2009,2,-6.96,-1391430
9,2005-04-08,Kung Fu Hustle,20000000,17104669,102034104,2005,4,410.17,82034104
10,2002-07-26,The Country Bears,20000000,16988996,16988996,2002,7,-15.06,-3011004
11,2017-09-29,Flatliners,20000000,16883115,45173738,2017,9,125.87,25173738
12,2007-03-16,Dead Silence,20000000,16574590,20614661,2007,3,3.07,614661
13,2003-11-21,21 Grams,20000000,16248701,59667625,2003,11,198.34,39667625
14,2009-12-04,Armored,20000000,15988876,23661038,2009,12,18.31,3661038
15,2007-12-14,The Kite Runner,20000000,15800078,74180745,2007,12,270.9,54180745
16,2004-09-03,Paparazzi,20000000,15712072,16612072,2004,9,-16.94,-3387928
17,2003-01-17,A Guy Thing,20000000,15543862,17430594,2003,1,-12.85,-2569406
19,2000-07-21,Loser,20000000,15464026,18250106,2000,7,-8.75,-1749894
21,2009-09-23,Capitalism: A Love Story,20000000,14363397,19121531,2009,9,-4.39,-878469
22,2012-04-13,Lockout,20000000,14326865,33943049,2012,4,69.72,13943049
23,2008-08-29,Disaster Movie,20000000,14190901,36720752,2008,8,83.6,16720752
24,2011-09-30,What's Your Number?,20000000,14011084,30163785,2011,9,50.82,10163785
26,2009-04-17,Crank 2: High Voltage,20000000,13684249,35472739,2009,4,77.36,15472739
27,2015-10-30,Burnt,20000000,13651946,36773510,2015,10,83.87,16773510
28,2004-04-30,Envy,20000000,13548322,14566246,2004,4,-27.17,-5433754
29,2006-10-13,One Night with the King,20000000,13395961,13725032,2006,10,-31.37,-6274968
31,2008-09-19,Ghost Town,20000000,13367624,29958228,2008,9,49.79,9958228
32,2002-11-22,The Quiet American,20000000,12987647,26348203,2002,11,31.74,6348203
33,2016-02-26,Triple 9,20000000,12639297,25943792,2016,2,29.72,5943792
34,2016-09-02,The Light Between Oceans,20000000,12545979,22281732,2016,9,11.41,2281732
35,2005-10-28,The Weather Man,20000000,12482775,15466961,2005,10,-22.67,-4533039
36,2002-08-23,Undisputed,20000000,12398628,12398628,2002,8,-38.01,-7601372
37,2009-03-27,12 Rounds,20000000,12234694,17306648,2009,3,-13.47,-2693352
38,2010-10-01,Let Me In,20000000,12134935,28270399,2010,10,41.35,8270399
40,2008-02-22,Be Kind Rewind,20000000,11175164,30894247,2008,2,54.47,10894247
41,2005-12-09,Mrs. Henderson Presents,20000000,11036366,27836366,2005,12,39.18,7836366
46,2007-08-31,Death Sentence,20000000,9534258,16907831,2007,8,-15.46,-3092169
47,2016-06-03,Popstar: Never Stop Never Stopping,20000000,9496130,9537120,2016,6,-52.31,-10462880
48,2017-10-27,Thank You for Your Service,20000000,9479390,9985316,2017,10,-50.07,-10014684
49,2009-12-04,Everybody's Fine,20000000,9208876,9208876,2009,12,-53.96,-10791124
50,2004-08-27,Superbabies: Baby Geniuses 2,20000000,9109322,9355369,2004,8,-53.22,-10644631
51,2013-09-20,Battle of the Year,20000000,8888355,16723377,2013,9,-16.38,-3276623
52,2016-04-29,Ratchet and Clank,20000000,8813410,14365639,2016,4,-28.17,-5634361
53,2007-08-17,Death at a Funeral,20000000,8580428,46790428,2007,8,133.95,26790428
54,2005-09-09,The Man,20000000,8330720,10393696,2005,9,-48.03,-9606304
55,2007-01-05,Code Name: The Cleaner,20000000,8135024,8135024,2007,1,-59.32,-11864976
56,2014-12-12,Inherent Vice,20000000,8110975,14772346,2014,12,-26.14,-5227654
57,2004-04-16,Connie & Carla,20000000,8047525,8047525,2004,4,-59.76,-11952475
58,2013-10-11,Machete Kills,20000000,8008161,18273009,2013,10,-8.63,-1726991
60,2006-02-24,Doogal,20000000,7578946,28058652,2006,2,40.29,8058652
61,2005-09-16,Proof,20000000,7535331,8284331,2005,9,-58.58,-11715669
62,2008-10-03,An American Carol,20000000,7013191,7022183,2008,10,-64.89,-12977817
63,2003-03-14,Willard,20000000,6882696,6882696,2003,3,-65.59,-13117304
64,2008-02-01,Strange Wilderness,20000000,6575282,6947084,2008,2,-65.26,-13052916
65,2015-04-24,Little Boy,20000000,6485961,17769299,2015,4,-11.15,-2230701
67,2012-10-26,Chasing Mavericks,20000000,6002756,8300821,2012,10,-58.5,-11699179
68,2014-12-31,A Most Violent Year,20000000,5749134,8846875,2014,12,-55.77,-11153125
69,2011-11-23,A Dangerous Method,20000000,5702083,14807531,2011,11,-25.96,-5192469
70,2006-07-07,A Scanner Darkly,20000000,5501616,7405084,2006,7,-62.97,-12594916
71,2009-08-14,Bandslam,20000000,5210988,12967829,2009,8,-35.16,-7032171
72,2005-01-28,Alone in the Dark,20000000,5178569,10588079,2005,1,-47.06,-9411921
73,2004-10-29,Birth,20000000,5005899,14603001,2004,10,-26.98,-5396999
74,2016-08-26,Hands of Stone,20000000,4712792,5031975,2016,8,-74.84,-14968025
75,2008-10-24,Passchendaele,20000000,4452423,4453327,2008,10,-77.73,-15546673
76,2008-10-03,Flash of Genius,20000000,4442377,4504111,2008,10,-77.48,-15495889
77,2007-11-21,Iâm Not There,20000000,4017609,12397613,2007,11,-38.01,-7602387
78,2012-09-07,The Cold Light of Day,20000000,3763583,25361206,2012,9,26.81,5361206
79,2009-05-15,The Brothers Bloom,20000000,3531756,5531756,2009,5,-72.34,-14468244
80,2008-10-24,"Synecdoche, New York",20000000,3083538,4383538,2008,10,-78.08,-15616462
81,2018-10-26,Suspiria,20000000,2483472,7034615,2018,10,-64.83,-12965385
82,2017-11-03,LBJ,20000000,2468683,2507181,2017,11,-87.46,-17492819
84,2004-03-19,Bon Voyage,20000000,2353728,8361736,2004,3,-58.19,-11638264
85,2015-11-13,My All-American,20000000,2246000,2246000,2015,11,-88.77,-17754000
87,2006-05-05,The Proposition,20000000,1903434,5313608,2006,5,-73.43,-14686392
88,2003-08-22,Marci X,20000000,1646664,1646664,2003,8,-91.77,-18353336
89,2002-12-06,Equilibrium,20000000,1190018,5345869,2002,12,-73.27,-14654131
90,2011-04-29,Dylan Dog: Dead of Night,20000000,1186538,6093725,2011,4,-69.53,-13906275
91,2012-08-29,The Oogieloves in the BIG Balloon Adventure,20000000,1065907,1065907,2012,8,-94.67,-18934093
92,2008-05-23,The Children of Huang Shi,20000000,1031872,8221700,2008,5,-58.89,-11778300
93,2000-10-20,The Yards,20000000,882710,2282710,2000,10,-88.59,-17717290
94,2010-08-06,Middle Men,20000000,754301,754301,2010,8,-96.23,-19245699
95,2017-04-28,JÃ¬yÃ¬ dÃ shÄ«,20000000,587470,43888531,2017,4,119.44,23888531
96,2010-12-03,All Good Things,20000000,582024,873617,2010,12,-95.63,-19126383
97,2015-11-13,By the Sea,20000000,538460,3727746,2015,11,-81.36,-16272254
98,2005-03-18,Steamboy,20000000,468867,10468867,2005,3,-47.66,-9531133
99,2005-04-22,The Game of Their Lives,20000000,375474,375474,2005,4,-98.12,-19624526
1,2010-12-10,The Tempest,20000000,277943,277943,2010,12,-98.61,-19722057
2,2008-03-07,é·æ±ä¸è (CJ7),20000000,206678,47300771,2008,3,136.5,27300771
3,2009-09-18,The Burning Plain,20000000,200730,1167092,2009,9,-94.16,-18832908
5,2003-04-25,People I Know,20000000,121972,5694213,2003,4,-71.53,-14305787
6,2015-10-30,Regression,20000000,55039,15824374,2015,10,-20.88,-4175626
7,2008-12-31,Admiral,20000000,0,38585047,2008,12,92.93,18585047
8,2012-12-31,Zambezia,20000000,0,34454336,2012,12,72.27,14454336
9,2010-04-13,Three Kingdoms: Resurrection of the Dragon,20000000,0,22139590,2010,4,10.7,2139590
10,2004-03-31,The Touch,20000000,0,5918742,2004,3,-70.41,-14081258
11,2015-05-29,Survivor,20000000,0,1703281,2015,5,-91.48,-18296719
12,2016-11-18,The History of Love,20000000,0,476624,2016,11,-97.62,-19523376
18,2009-08-21,Der Baader Meinhof Komplex,19700000,476270,16498827,2009,8,-16.25,-3201173
19,2017-12-01,The Shape of Water,19500000,63859435,195790794,2017,12,904.06,176290794
20,2012-11-23,De rouille et dâos,19500000,2061449,29393634,2012,11,50.74,9893634
21,2006-12-20,The Painted Veil,19400000,8060487,15118795,2006,12,-22.07,-4281205
22,2013-08-23,The Frozen Ground,19200000,0,5617460,2013,8,-70.74,-13582540
23,2011-07-29,The Devil's Double,19100000,1361512,5965646,2011,7,-68.77,-13134354
26,2000-07-07,Scary Movie,19000000,157019771,277200000,2000,7,1358.95,258200000
27,2011-06-24,Bad Teacher,19000000,100292856,215448997,2011,6,1033.94,196448997
28,2016-08-12,Sausage Party,19000000,97670358,141344255,2016,8,643.92,122344255
30,2003-01-10,Just Married,19000000,56127162,101564935,2003,1,434.55,82564935
31,2009-09-11,I Can Do Bad All By Myself,19000000,51733921,51733921,2009,9,172.28,32733921
32,2004-07-16,A Cinderella Story,19000000,51438175,70164105,2004,7,269.28,51164105
34,2001-10-26,Thirteen Ghosts,19000000,41867960,68467960,2001,10,260.36,49467960
36,2010-02-26,The Crazies,19000000,39123589,56445534,2010,2,197.08,37445534
37,2009-01-16,Notorious,19000000,36843682,44972183,2009,1,136.7,25972183
38,2018-11-02,Nobodyâs Fool,19000000,31713110,32589493,2018,11,71.52,13589493
39,2010-08-20,The Switch,19000000,27758465,49858465,2010,8,162.41,30858465
40,2010-01-08,Leap Year,19000000,25918920,32618920,2010,1,71.68,13618920
41,2013-11-08,The Book Thief,19000000,21488481,76086711,2013,11,300.46,57086711
42,2007-10-19,"Gone, Baby, Gone",19000000,20300218,34352162,2007,10,80.8,15352162
43,2000-07-26,Thomas and the Magic Railroad,19000000,15911332,15911332,2000,7,-16.26,-3088668
45,2002-09-20,Sen to Chihiro no Kamikakushi,19000000,10049886,274949886,2002,9,1347.1,255949886
46,2008-10-17,Sex Drive,19000000,8402485,10412485,2008,10,-45.2,-8587515
48,2011-03-04,Take Me Home Tonight,19000000,6928068,7576604,2011,3,-60.12,-11423396
49,2012-09-28,Won't Back Down,19000000,5310554,5745503,2012,9,-69.76,-13254497
50,2018-06-01,Action Point,19000000,5059608,5103675,2018,6,-73.14,-13896325
53,2011-12-13,George Balanchine\'s The Nutcracker,19000000,2119994,2119994,2011,12,-88.84,-16880006
56,2005-06-24,George A. Romero's Land of the Dead,18975000,20700082,47751015,2005,6,151.65,28776015
57,2006-12-15,IndigÃ¨nes,18900000,320700,26063572,2006,12,37.9,7163572
58,2005-04-15,The Amityville Horror,18500000,65233369,109175673,2005,4,490.14,90675673
59,2002-12-06,Adaptation,18500000,22498520,32531759,2002,12,75.85,14031759
60,2009-10-02,The Invention of Lying,18500000,18451251,32679264,2009,10,76.64,14179264
62,2008-07-04,Ne le dis Ã personne,18500000,6198883,33954018,2008,7,83.54,15454018
63,2001-02-02,Left Behind,18500000,4221341,4221341,2001,2,-77.18,-14278659
64,2014-05-09,Neighbors,18000000,150086800,270944428,2014,5,1405.25,252944428
65,2006-11-03,Borat,18000000,128505958,261443242,2006,11,1352.46,243443242
68,2001-07-13,Legally Blonde,18000000,96493426,141809235,2001,7,687.83,123809235
69,2004-04-30,Mean Girls,18000000,86047227,130953026,2004,4,627.52,112953026
71,2005-09-09,The Exorcism of Emily Rose,18000000,75072454,144529078,2005,9,702.94,126529078
73,2004-01-01,Barbershop 2: Back in Business,18000000,65070412,65842412,2004,1,265.79,47842412
74,2005-12-16,The Family Stone,18000000,60062868,92357499,2005,12,413.1,74357499
75,2003-11-26,Bad Santa,18000000,60060328,77147031,2003,11,328.59,59147031
77,2016-03-25,My Big Fat Greek Wedding 2,18000000,59689605,92096558,2016,3,411.65,74096558
78,2015-09-11,The Perfect Guy,18000000,57027435,60278166,2015,9,234.88,42278166
80,2011-03-25,Diary of a Wimpy Kid: Rodrick Rules,18000000,52698535,73695194,2011,3,309.42,55695194
82,2008-04-11,Prom Night,18000000,43869350,57193655,2008,4,217.74,39193655
83,2011-04-08,Soul Surfer,18000000,43853424,47158652,2011,4,161.99,29158652
84,2003-09-26,Under the Tuscan Sun,18000000,43601508,57490024,2003,9,219.39,39490024
85,2018-06-29,Uncle Drew,18000000,42469946,46527161,2018,6,158.48,28527161
86,2014-10-17,Birdman or (The Unexpected Virtue of Ignorance),18000000,42340598,103215094,2014,10,473.42,85215094
88,2001-12-26,Gosford Park,18000000,41300105,41300105,2001,12,129.45,23300105
89,2002-01-11,Orange County,18000000,41059716,43308707,2002,1,140.6,25308707
90,2013-07-26,Blue Jasmine,18000000,33404871,102912961,2013,7,471.74,84912961
91,2006-04-28,United 93,18000000,31567134,77635035,2006,4,331.31,59635035
92,2003-12-05,Honey,18000000,30272254,62646763,2003,12,248.04,44646763
93,2005-10-14,The Fog,18000000,29511112,37048526,2005,10,105.83,19048526
95,2015-08-07,Ricki and the Flash,18000000,26839498,41166033,2015,8,128.7,23166033
98,2015-11-13,Love the Coopers,18000000,26302731,42227490,2015,11,134.6,24227490
100,2009-04-10,Observe and Report,18000000,24007324,27148898,2009,4,50.83,9148898
2,2009-09-18,Love Happens,18000000,22965110,36133014,2009,9,100.74,18133014
3,2009-09-25,Fame,18000000,22455510,80227619,2009,9,345.71,62227619
4,2017-04-28,The Circle,18000000,20497844,40651864,2017,4,125.84,22651864
6,2010-11-05,127 Hours,18000000,18335230,60217171,2010,11,234.54,42217171
7,2000-05-19,Small Time Crooks,18000000,17266359,29934477,2000,5,66.3,11934477
8,2000-05-12,Center Stage,18000000,17200925,21361109,2000,5,18.67,3361109
9,2016-01-15,Norm of the North,18000000,17062499,30535660,2016,1,69.64,12535660
10,2004-02-06,Catch That Kid,18000000,16703799,16959614,2004,2,-5.78,-1040386
11,2013-08-16,Jobs,18000000,16131410,43402515,2013,8,141.13,25402515
12,2001-10-26,Life as a House,18000000,15652637,23889158,2001,10,32.72,5889158
13,2010-01-08,Youth in Revolt,18000000,15285588,19685588,2010,1,9.36,1685588
14,2014-07-25,And So It Goes,18000000,15160801,17920013,2014,7,-0.44,-79987
15,2009-07-10,"I Love You, Beth Cooper",18000000,14800725,16382538,2009,7,-8.99,-1617462
17,2001-03-30,The Tailor of Panama,18000000,13491653,27491653,2001,3,52.73,9491653
19,2014-01-31,Labor Day,18000000,13371528,14189810,2014,1,-21.17,-3810190
20,2013-08-30,Getaway,18000000,10501938,11813989,2013,8,-34.37,-6186011
22,2004-10-15,Being Julia,18000000,7739049,14488705,2004,10,-19.51,-3511295
25,2010-01-15,The Last Station,18000000,6617867,15696146,2010,1,-12.8,-2303854
28,2008-06-06,Mongol,18000000,5705761,27147349,2008,6,50.82,9147349
29,2008-10-08,RocknRolla,18000000,5700626,27794339,2008,10,54.41,9794339
31,2010-08-20,Mao's Last Dancer,18000000,4806750,25941437,2010,8,44.12,7941437
33,2014-04-11,The Railway Man,18000000,4438438,23910210,2014,4,32.83,5910210
35,2016-03-18,Midnight Special,18000000,3712282,7680250,2016,3,-57.33,-10319750
36,2016-11-25,Miss Sloane,18000000,3500605,7719630,2016,11,-57.11,-10280370
37,2013-09-27,Metallica Through the Never,18000000,3419967,9082906,2013,9,-49.54,-8917094
38,2003-09-19,Anything Else,18000000,3203044,13203044,2003,9,-26.65,-4796956
40,2017-03-17,T2: Trainspotting,18000000,2402004,42091262,2017,3,133.84,24091262
41,2009-12-30,Das Weisse Band: Eine deutsche Kindergeschichte,18000000,2222862,25727044,2009,12,42.93,7727044
43,2013-03-01,Phantom,18000000,1034589,1199510,2013,3,-93.34,-16800490
44,2002-04-26,The Salton Sea,18000000,676698,676698,2002,4,-96.24,-17323302
45,2009-04-24,The Informers,18000000,315000,315000,2009,4,-98.25,-17685000
47,2010-10-15,Carlos,18000000,145526,1619153,2010,10,-91.0,-16380847
48,2006-09-22,Renaissance,18000000,70644,2401413,2006,9,-86.66,-15598587
49,2008-12-31,I Come with the Rain,18000000,0,627422,2008,12,-96.51,-17372578
50,2016-04-15,I Am Wrath,18000000,0,309608,2016,4,-98.28,-17690392
51,2014-11-14,Wolves,18000000,0,94953,2014,11,-99.47,-17905047
56,2012-07-13,Red Lights,17700000,49521,14518884,2012,7,-17.97,-3181116
57,2007-08-17,Superbad,17500000,121463226,169955142,2007,8,871.17,152455142
58,2009-02-20,Madea Goes To Jail,17500000,90508336,90508336,2009,2,417.19,73008336
59,2008-02-14,Step Up 2 the Streets,17500000,58017783,148586910,2008,2,749.07,131086910
60,2006-01-13,Hoodwinked,17500000,51386611,109843390,2006,1,527.68,92343390
61,2004-12-22,Hotel Rwanda,17500000,23519128,36521223,2004,12,108.69,19021223
62,2006-08-25,Beerfest,17500000,19185184,20159316,2006,8,15.2,2659316
63,2013-11-27,Black Nativity,17500000,7018188,7285135,2013,11,-58.37,-10214865
64,2003-04-25,City of Ghosts,17500000,325491,325491,2003,4,-98.14,-17174509
65,2007-12-31,Taxi 4,17500000,0,60865364,2007,12,247.8,43365364
66,2018-04-06,A Quiet Place,17000000,188024361,334522294,2018,4,1867.78,317522294
67,2001-08-10,The Others,17000000,96522687,207765056,2001,8,1122.15,190765056
69,2014-08-13,Letâs Be Cops,17000000,82390774,136890774,2014,8,705.24,119890774
72,2004-10-22,Sideways,17000000,71502303,109793192,2004,10,545.84,92793192
73,2013-11-15,The Best Man Holiday,17000000,70525195,72835710,2013,11,328.45,55835710
74,2009-02-13,Friday the 13th,17000000,65002019,92670237,2009,2,445.12,75670237
75,2012-09-28,Pitch Perfect,17000000,65001093,116044347,2012,9,582.61,99044347
77,2013-04-05,Evil Dead,17000000,54239856,97778356,2013,4,475.17,80778356
78,2004-08-27,Jet Li's Hero,17000000,53652140,177535958,2004,8,944.33,160535958
79,2010-10-29,Saw 3D,17000000,45710178,133735284,2010,10,686.68,116735284
80,2015-02-20,"McFarland, USA",17000000,44480275,45707924,2015,2,168.87,28707924
81,2016-11-11,Almost Christmas,17000000,42065185,42493506,2016,11,149.96,25493506
82,2006-03-10,The Hills Have Eyes,17000000,41778863,70355813,2006,3,313.86,53355813
83,2002-03-01,40 Days and 40 Nights,17000000,37939782,95092667,2002,3,459.37,78092667
84,2003-10-10,Good Boy!,17000000,37667746,45312217,2003,10,166.54,28312217
85,2007-01-26,Smokin' Aces,17000000,35662731,57263440,2007,1,236.84,40263440
87,2011-03-04,Beastly,17000000,27865571,38028230,2011,3,123.7,21028230
88,2010-03-05,Brooklyn's Finest,17000000,27163593,39233233,2010,3,130.78,22233233
90,2010-08-20,Lottery Ticket,17000000,24719879,24719879,2010,8,45.41,7719879
91,2003-09-05,Dickie Roberts: Former Child Star,17000000,22734486,23734486,2003,9,39.61,6734486
92,2006-03-31,ATL,17000000,21170563,21170563,2006,3,24.53,4170563
93,2001-08-24,Summer Catch,17000000,19693891,19693891,2001,8,15.85,2693891
95,2006-03-24,Larry the Cable Guy: Health Inspector,17000000,15680099,15680099,2006,3,-7.76,-1319901
96,2002-11-27,Wes Craven Presents: They,17000000,12840842,16140842,2002,11,-5.05,-859158
100,2009-06-05,My Life in Ruins,17000000,8677425,20477425,2009,6,20.46,3477425
1,2006-04-21,American Dreamz,17000000,7314027,16510971,2006,4,-2.88,-489029
2,2008-01-25,How She Move,17000000,7070641,8607815,2008,1,-49.37,-8392185
3,2006-02-24,Running Scared,17000000,6855137,9729088,2006,2,-42.77,-7270912
4,2012-08-24,The Apparition,17000000,4936819,10637281,2012,8,-37.43,-6362719
5,2004-04-30,Bobby Jones: Stroke of Genius,17000000,2694071,2694071,2004,4,-84.15,-14305929
7,2010-12-25,L'illusionniste,17000000,2231474,8609949,2010,12,-49.35,-8390051
9,2003-10-17,Veronica Guerin,17000000,1569918,9438074,2003,10,-44.48,-7561926
10,2016-06-10,Genius,17000000,1361045,7265283,2016,6,-57.26,-9734717
11,2007-11-14,Southland Tales,17000000,275380,364607,2007,11,-97.86,-16635393
12,2015-06-26,Escobar: Paradise Lost,17000000,195792,3917679,2015,6,-76.95,-13082321
13,2017-09-26,"Mune, le gardien de la lune",17000000,0,14534046,2017,9,-14.51,-2465954
14,2009-06-23,Chasseurs de dragons,17000000,0,13446115,2009,6,-20.91,-3553885
17,2016-03-11,The Young Messiah,16800000,6469813,7313697,2016,3,-56.47,-9486303
18,2006-11-10,FUR: An Imaginary Portrait of Diane Arbus,16800000,223202,2281089,2006,11,-86.42,-14518911
22,2006-08-18,The Illusionist,16500000,39868642,83792062,2006,8,407.83,67292062
23,2007-08-03,Becoming Jane,16500000,18663911,39380876,2007,8,138.67,22880876
24,2003-12-19,House of Sand and Fog,16500000,13005485,16157923,2003,12,-2.07,-342077
25,2007-09-21,Sydney White,16500000,11892415,13636339,2007,9,-17.36,-2863661
26,2007-12-31,Arn - Tempelriddaren,16500000,0,21404122,2007,12,29.72,4904122
30,2000-05-19,Road Trip,16000000,68525609,119739110,2000,5,648.37,103739110
33,2012-05-25,Moonrise Kingdom,16000000,45512466,68848446,2012,5,330.3,52848446
34,2011-11-25,The Artist,16000000,44667095,128256712,2011,11,701.6,112256712
35,2009-01-09,The Unborn,16000000,42670410,78208812,2009,1,388.81,62208812
36,2002-08-02,The Master of Disguise,16000000,40363530,40363530,2002,8,152.27,24363530
37,2006-10-06,The Texas Chainsaw Massacre: The Beginning,16000000,39517763,50517763,2006,10,215.74,34517763
38,2006-12-29,El Laberinto del Fauno,16000000,37634615,87041569,2006,12,444.01,71041569
39,2011-02-04,The Roommate,16000000,37300107,52545707,2011,2,228.41,36545707
40,2007-02-02,The Messengers,16000000,35374833,53774833,2007,2,236.09,37774833
41,2001-03-02,See Spot Run,16000000,33357476,43057552,2001,3,169.11,27057552
43,2001-06-27,Baby Boy,16000000,28734552,28734552,2001,6,79.59,12734552
44,2001-04-11,Joe Dirt,16000000,27087695,30987695,2001,4,93.67,14987695
45,2008-09-12,The Women,16000000,26902075,50103808,2008,9,213.15,34103808
46,2007-04-20,Hot Fuzz,16000000,23618786,81742618,2007,4,410.89,65742618
47,2008-08-15,Vicky Cristina Barcelona,16000000,23216709,104504817,2008,8,553.16,88504817
48,2000-06-16,Boys and Girls,16000000,21799652,21799652,2000,6,36.25,5799652
49,2018-06-13,Superfly,16000000,20537137,20723581,2018,6,29.52,4723581
51,2010-03-12,Remember Me,16000000,19068240,56506120,2010,3,253.16,40506120
52,2002-10-11,White Oleander,16000000,16357770,21657770,2002,10,35.36,5657770
53,2009-09-18,Jennifer's Body,16000000,16204793,31943401,2009,9,99.65,15943401
54,2000-03-03,Drowning Mona,16000000,15427192,15980376,2000,3,-0.12,-19624
56,2003-07-18,How to Deal,16000000,14108518,14108518,2003,7,-11.82,-1891482
57,2014-10-03,Left Behind,16000000,14019924,20769209,2014,10,29.81,4769209
58,2004-05-28,Soul Plane,16000000,13922211,14553807,2004,5,-9.04,-1446193
60,2012-06-29,People Like Us,16000000,12431792,12617472,2012,6,-21.14,-3382528
62,2004-09-03,The Cookout,16000000,11540112,11540112,2004,9,-27.87,-4459888
65,2016-11-18,Bleed for This,16000000,5083906,6603926,2016,11,-58.73,-9396074
66,2002-05-03,Hollywood Ending,16000000,4839383,14839383,2002,5,-7.25,-1160617
67,2000-09-15,Duets,16000000,4734235,6615452,2000,9,-58.65,-9384548
69,2007-10-19,Things We Lost in the Fire,16000000,3287315,8120148,2007,10,-49.25,-7879852
70,2014-11-14,The Homesman,16000000,2429989,8217571,2014,11,-48.64,-7782429
71,2013-04-05,Trance,16000000,2322593,22594052,2013,4,41.21,6594052
72,2014-05-16,The Immigrant,16000000,2013456,7585011,2014,5,-52.59,-8414989
74,2005-12-21,The White Countess,16000000,1669971,2814566,2005,12,-82.41,-13185434
75,2008-07-25,Bienvenue chez les Ch'tis,16000000,1477650,247474497,2008,7,1446.72,231474497
76,2014-10-01,"Men, Women and Children",16000000,705908,1685403,2014,10,-89.47,-14314597
77,2010-09-24,Enter the Void,16000000,337997,1467278,2010,9,-90.83,-14532722
78,2008-12-31,Good,16000000,31631,31631,2008,12,-99.8,-15968369
79,2012-11-02,Vamps,16000000,3361,94812,2012,11,-99.41,-15905188
80,2010-05-11,Haeundae,16000000,0,64733391,2010,5,304.58,48733391
81,2010-03-09,Hachiko: A Dog's Story,16000000,0,47707417,2010,3,198.17,31707417
82,2013-12-31,Zulu,16000000,0,1844228,2013,12,-88.47,-14155772
83,2018-12-21,Second Act,15700000,39282227,63288854,2018,12,303.11,47588854
84,2002-06-21,Juwanna Mann,15600000,13571817,13771817,2002,6,-11.72,-1828183
85,2007-06-08,La MÃ´me,15500000,10299782,88611837,2007,6,471.69,73111837
86,2002-11-15,Ararat,15500000,1693000,1693000,2002,11,-89.08,-13807000
87,2007-04-13,Slow Burn,15500000,1237615,1237615,2007,4,-92.02,-14262385
88,2005-04-22,Madison,15500000,517262,517262,2005,4,-96.66,-14982738
89,2010-02-26,The Yellow Handkerchief,15500000,318623,318623,2010,2,-97.94,-15181377
90,2002-09-27,Wasabi,15300000,81525,7000000,2002,9,-54.25,-8300000
91,2006-03-31,Slither,15250000,7802450,12930343,2006,3,-15.21,-2319657
97,2010-11-26,The Kingâs Speech,15000000,138797449,430821168,2010,11,2772.14,415821168
99,2000-12-08,"Crouching Tiger, Hidden Dragon",15000000,128067808,213514672,2000,12,1323.43,198514672
2,2017-08-11,Annabelle: Creation,15000000,102092201,305384865,2017,8,1935.9,290384865
3,2013-10-25,Jackass Presents: Bad Grandpa,15000000,102003019,160903019,2013,10,972.69,145903019
6,2014-11-28,The Imitation Game,15000000,91125143,227740463,2014,11,1418.27,212740463
9,2013-01-18,Mama,15000000,71628180,148095566,2013,1,887.3,133095566
13,2010-03-19,Diary of a Wimpy Kid,15000000,64003625,76954311,2010,3,413.03,61954311
15,2007-08-31,Halloween,15000000,58269151,77514401,2007,8,416.76,62514401
16,2006-09-30,The Queen,15000000,56441711,128885873,2006,9,759.24,113885873
17,2007-10-12,Why Did I Get Married?,15000000,55204525,55934178,2007,10,272.89,40934178
18,2012-02-03,The Woman in Black,15000000,54333290,128955898,2012,2,759.71,113955898
21,2018-08-10,BlacKkKlansman,15000000,49275340,93017335,2018,8,520.12,78017335
22,2006-02-03,When a Stranger Calls,15000000,47860214,67215435,2006,2,348.1,52215435
23,2002-02-08,Big Fat Liar,15000000,47811275,52461017,2002,2,249.74,37461017
26,2013-02-22,Snitch,15000000,42930462,57907734,2013,2,286.05,42907734
27,2003-05-02,The Lizzie McGuire Movie,15000000,42734455,55534455,2003,5,270.23,40534455
28,2015-12-04,Krampus,15000000,42725475,61788393,2015,12,311.92,46788393
29,2012-09-21,End of Watch,15000000,41003371,57586606,2012,9,283.91,42586606
32,2001-12-14,Not Another Teen Movie,15000000,37882551,62401343,2001,12,316.01,47401343
33,2014-12-03,Wild,15000000,37880356,52460543,2014,12,249.74,37460543
35,2014-11-07,The Theory of Everything,15000000,35893537,123327692,2014,11,722.18,108327692
36,2011-09-16,Drive,15000000,35060689,81357930,2011,9,442.39,66357930
37,2000-03-31,The Skulls,15000000,35007180,35007180,2000,3,133.38,20007180
39,2018-11-23,The Favourite,15000000,34366783,94113929,2018,11,527.43,79113929
40,2003-04-18,Malibu's Most Wanted,15000000,34308901,34499204,2003,4,129.99,19499204
41,2009-09-04,All About Steve,15000000,33862903,40127259,2009,9,167.52,25127259
42,2000-04-28,Where the Heart Is,15000000,33771174,40862054,2000,4,172.41,25862054
43,2009-08-28,Halloween 2,15000000,33392973,38512850,2009,8,156.75,23512850
44,2009-03-13,The Last House on the Left,15000000,32752215,46526243,2009,3,210.17,31526243
45,2005-02-18,Because of Winn-Dixie,15000000,32647042,33508485,2005,2,123.39,18508485
46,2005-02-04,The Wedding Date,15000000,31726995,47175038,2005,2,214.5,32175038
48,2002-07-12,Halloween: Resurrection,15000000,30259652,37659652,2002,7,151.06,22659652
49,2007-12-25,The Great Debaters,15000000,30226144,30261293,2007,12,101.74,15261293
50,2014-08-22,When the Game Stands Tall,15000000,30127963,30138912,2014,8,100.93,15138912
52,2004-02-20,Confessions of a Teenage Drama Queen,15000000,29331068,33118854,2004,2,120.79,18118854
54,2007-05-11,28 Weeks Later,15000000,28638916,64232714,2007,5,328.22,49232714
56,2000-04-21,Love and Basketball,15000000,27441122,27709625,2000,4,84.73,12709625
57,2017-09-08,Home Again,15000000,27020284,37336874,2017,9,148.91,22336874
58,2000-10-27,Book of Shadows: Blair Witch 2,15000000,26421314,47721314,2000,10,218.14,32721314
60,2010-07-23,Ramona and Beezus,15000000,26167002,27469621,2010,7,83.13,12469621
61,2014-08-27,The November Man,15000000,25018119,34820335,2014,8,132.14,19820335
63,2005-12-28,Match Point,15000000,23089926,87973835,2005,12,486.49,72973835
66,2000-09-22,Urban Legends: Final Cut,15000000,21468807,38574362,2000,9,157.16,23574362
67,2013-03-29,The Place Beyond the Pines,15000000,21403519,47011449,2013,3,213.41,32011449
68,2006-10-20,Flicka,15000000,21000147,21896367,2006,10,45.98,6896367
69,2007-03-23,The Hills Have Eyes II,15000000,20804166,37466538,2007,3,149.78,22466538
70,2016-04-29,Keanu,15000000,20591853,20688141,2016,4,37.92,5688141
71,2010-12-22,Country Strong,15000000,20218921,20601987,2010,12,37.35,5601987
72,2002-10-11,Tuck Everlasting,15000000,19161999,19344615,2002,10,28.96,4344615
73,2006-10-13,The Marine,15000000,18844784,22165608,2006,10,47.77,7165608
76,2014-07-25,A Most Wanted Man,15000000,17237855,36068890,2014,7,140.46,21068890
77,2009-06-26,The Hurt Locker,15000000,17017811,49894223,2009,6,232.63,34894223
78,2000-01-28,Eye of the Beholder,15000000,16500786,18260865,2000,1,21.74,3260865
79,2012-11-02,The Man with the Iron Fists,15000000,15634090,22018988,2012,11,46.79,7018988
81,2019-02-01,Miss Bala,15000000,14998027,15362298,2019,2,2.42,362298
82,2012-11-30,Killing Them Softly,15000000,14945541,39238443,2012,11,161.59,24238443
83,2001-04-20,Freddy Got Fingered,15000000,14249005,14249005,2001,4,-5.01,-750995
84,2011-08-19,One Day,15000000,13843771,59168692,2011,8,294.46,44168692
85,2004-06-25,De-Lovely,15000000,13337299,18524496,2004,6,23.5,3524496
86,2009-10-02,Whip It,15000000,13077184,18889972,2009,10,25.93,3889972
87,2008-01-11,The Pirates Who Don't Do Anything: A VeggieTales Movie,15000000,12981269,13248444,2008,1,-11.68,-1751556
88,2008-01-23,U2 3D,15000000,12898847,26170402,2008,1,74.47,11170402
89,2000-09-01,Highlander: Endgame,15000000,12801190,12801190,2000,9,-14.66,-2198810
90,2017-01-20,The Founder,15000000,12786053,24403192,2017,1,62.69,9403192
91,2006-08-25,Idlewild,15000000,12669914,12669914,2006,8,-15.53,-2330086
92,2003-04-25,Confidence,15000000,12212417,12212417,2003,4,-18.58,-2787583
93,2002-10-11,Knockaround Guys,15000000,11660180,12419700,2002,10,-17.2,-2580300
98,2000-03-24,Here on Earth,15000000,10494147,10845127,2000,3,-27.7,-4154873
99,2004-10-08,Raise Your Voice,15000000,10411980,14811980,2004,10,-1.25,-188020
2,2007-03-02,Black Snake Moan,15000000,9396870,10951153,2007,3,-26.99,-4048847
3,2003-02-21,Dark Blue,15000000,9237470,12262065,2003,2,-18.25,-2737935
4,2007-06-22,A Mighty Heart,15000000,9176787,19153568,2007,6,27.69,4153568
6,2016-09-23,Queen of Katwe,15000000,8874389,10055481,2016,9,-32.96,-4944519
7,2000-03-24,Whatever it Takes,15000000,8735529,8735529,2000,3,-41.76,-6264471
8,2003-03-21,Boat Trip,15000000,8586376,14933713,2003,3,-0.44,-66287
9,2002-05-22,The Importance of Being Earnest,15000000,8378141,8378141,2002,5,-44.15,-6621859
11,2006-05-05,Hoot,15000000,8117637,8224998,2006,5,-45.17,-6775002
12,2008-02-08,In Bruges,15000000,7800825,34533783,2008,2,130.23,19533783
13,2013-01-04,Promised Land,15000000,7597898,12394562,2013,1,-17.37,-2605438
14,2001-10-08,Mulholland Drive,15000000,7219578,20785973,2001,10,38.57,5785973
15,2018-06-08,Hotel Artemis,15000000,6708137,12758799,2018,6,-14.94,-2241201
16,2008-08-20,The Rocker,15000000,6409528,8767338,2008,8,-41.55,-6232662
17,2009-08-21,Post Grad,15000000,6382178,6563402,2009,8,-56.24,-8436598
18,2009-06-19,Whatever Works,15000000,5306706,35106706,2009,6,134.04,20106706
19,2000-07-19,The In Crowd,15000000,5217498,5217498,2000,7,-65.22,-9782502
20,2005-12-14,Los tres entierros de Melquiades Estrada,15000000,5027684,13454474,2005,12,-10.3,-1545526
22,2007-09-28,Se jie,15000000,4604982,65167430,2007,9,334.45,50167430
23,2005-10-21,"Kiss Kiss, Bang Bang",15000000,4235837,16829464,2005,10,12.2,1829464
25,2015-10-30,Scouts Guide to the Zombie Apocalypse,15000000,3703046,15554855,2015,10,3.7,554855
26,2007-01-26,Blood and Chocolate,15000000,3526588,6551310,2007,1,-56.32,-8448690
27,2010-09-22,You Will Meet a Tall Dark Stranger,15000000,3247816,34247816,2010,9,128.32,19247816
28,2015-10-23,Rock the Kasbah,15000000,3020665,3386153,2015,10,-77.43,-11613847
29,2010-09-15,Never Let Me Go,15000000,2434652,11173718,2010,9,-25.51,-3826282
30,2016-09-09,The Disappointments Room,15000000,2423467,3503761,2016,9,-76.64,-11496239
31,2003-12-25,The Company,15000000,2281585,3396508,2003,12,-77.36,-11603492
32,2008-07-18,Transsiberian,15000000,2203641,6379575,2008,7,-57.47,-8620425
35,2017-02-03,The Comedian,15000000,1658706,1658706,2017,2,-88.94,-13341294
36,2008-03-14,Funny Games,15000000,1294640,8200127,2008,3,-45.33,-6799873
37,2006-06-02,Banlieue 13,15000000,1200216,11599903,2006,6,-22.67,-3400097
39,2002-01-25,Metropolis,15000000,673414,1405032,2002,1,-90.63,-13594968
40,2015-10-16,CÃ¬kÃ¨ NiÃ¨ YinniÃ¡ng,15000000,632542,11279884,2015,10,-24.8,-3720116
42,2013-04-26,The Reluctant Fundamentalist,15000000,528731,528731,2013,4,-96.48,-14471269
43,2004-02-06,The Return,15000000,501752,5953886,2004,2,-60.31,-9046114
44,2003-07-25,Buffalo Soldiers,15000000,353743,353743,2003,7,-97.64,-14646257
45,2003-04-25,Steal (Canadian Release),15000000,220944,220944,2003,4,-98.53,-14779056
46,2010-08-27,Centurion,15000000,123570,7885048,2010,8,-47.43,-7114952
47,2009-10-23,Ong-Bak 2,15000000,102458,7583050,2009,10,-49.45,-7416950
49,2008-08-01,Midnight Meat Train,15000000,73548,1590246,2008,8,-89.4,-13409754
50,2013-09-06,Winnie Mandela,15000000,61847,61847,2013,9,-99.59,-14938153
51,2011-11-04,The Son of No One,15000000,30680,1148578,2011,11,-92.34,-13851422
52,2002-10-25,All the Queen's Men,15000000,22723,22723,2002,10,-99.85,-14977277
53,2007-10-05,The Good Night,15000000,22441,22441,2007,10,-99.85,-14977559
54,2013-12-06,Khumba,15000000,0,20898221,2013,12,39.32,5898221
55,2015-05-05,A Few Best Men,15000000,0,17224539,2015,5,14.83,2224539
56,2014-10-10,AutÃ³mata,15000000,0,6775458,2014,10,-54.83,-8224542
57,2015-12-31,Chiamatemi Francesco - Il papa della gente,15000000,0,3925769,2015,12,-73.83,-11074231
58,2008-12-31,Bathory,15000000,0,3436763,2008,12,-77.09,-11563237
59,2010-02-05,San suk si gin,15000000,0,2013340,2010,2,-86.58,-12986660
60,2005-12-31,Dungeons & Dragons: Wrath of the Dragon God,15000000,0,909822,2005,12,-93.93,-14090178
61,2017-02-17,In Dubious Battle,15000000,0,214182,2017,2,-98.57,-14785818
62,2015-09-01,Broken Horses,15000000,0,3471,2015,9,-99.98,-14996529
66,2015-07-01,Magic Mike XXL,14500000,66013057,123660597,2015,7,752.83,109160597
68,2011-07-22,Elle s'appelait Sarah,14500000,7691700,25480031,2011,7,75.72,10980031
69,2015-06-05,Freedom,14500000,0,872757,2015,6,-93.98,-13627243
71,2006-01-27,Manderlay,14200000,74205,543306,2006,1,-96.17,-13656694
74,2008-11-12,Slumdog Millionaire,14000000,141330703,384530440,2008,11,2646.65,370530440
79,2007-01-12,Stomp the Yard,14000000,61356221,75525718,2007,1,439.47,61525718
80,2009-01-16,My Bloody Valentine,14000000,51545952,102836002,2009,1,634.54,88836002
81,2012-08-31,The Possession,14000000,49130588,82925064,2012,8,492.32,68925064
86,2012-02-24,Tyler Perry's Good Deeds,14000000,35025791,35579177,2012,2,154.14,21579177
90,2012-01-13,The Iron Lady,14000000,29959436,115592104,2012,1,725.66,101592104
92,2002-10-04,Jonah: A VeggieTales Movie,14000000,25571351,25608779,2002,10,82.92,11608779
93,2002-03-08,All About the Benjamins,14000000,25482931,25873145,2002,3,84.81,11873145
95,2010-03-12,Our Family Wedding,14000000,20255281,21410546,2010,3,52.93,7410546
97,2006-05-05,An American Haunting,14000000,16298046,30443277,2006,5,117.45,16443277
98,2003-08-22,My Boss's Daughter,14000000,15549702,15549702,2003,8,11.07,1549702
99,2009-08-07,A Perfect Getaway,14000000,15515460,22815460,2009,8,62.97,8815460
4,2002-04-26,Jason X,14000000,13121555,16951798,2002,4,21.08,2951798
6,2007-03-16,I Think I Love My Wife,14000000,12559771,13205411,2007,3,-5.68,-794589
7,2015-02-20,Hot Tub Time Machine 2,14000000,12314651,12826644,2015,2,-8.38,-1173356
8,2006-11-17,Bobby,14000000,11242801,20597806,2006,11,47.13,6597806
9,2001-02-02,Head Over Heels,14000000,10397365,10397365,2001,2,-25.73,-3602635
10,2012-10-26,Fun Size,14000000,9409538,11166615,2012,10,-20.24,-2833385
12,2007-11-30,Le Scaphandre et le Papillon,14000000,5990075,22754472,2007,11,62.53,8754472
13,2006-10-06,Little Children,14000000,5463019,14121177,2006,10,0.87,121177
14,2000-04-21,Gossip,14000000,5108820,12591270,2000,4,-10.06,-1408730
16,2015-10-23,Suffragette,14000000,4702420,34044909,2015,10,143.18,20044909
17,2006-10-27,Catch a Fire,14000000,4299773,5782198,2006,10,-58.7,-8217802
18,2014-12-19,Mr. Turner,14000000,3958546,25187026,2014,12,79.91,11187026
19,2001-09-07,Soul Survivors,14000000,3100650,4288246,2001,9,-69.37,-9711754
20,2009-05-22,Easy Virtue,14000000,2656784,20537741,2009,5,46.7,6537741
22,2010-08-06,Flipped,14000000,1755212,4289993,2010,8,-69.36,-9710007
24,2010-06-25,Les herbes folles,14000000,403952,1903952,2010,6,-86.4,-12096048
25,2003-01-24,Amen,14000000,274299,274299,2003,1,-98.04,-13725701
26,2008-09-26,The Lucky Ones,14000000,266967,266967,2008,9,-98.09,-13733033
27,2011-09-30,Margaret,14000000,47185,623292,2011,9,-95.55,-13376708
28,2016-11-01,Reign of Assassins,14000000,0,11354230,2016,11,-18.9,-2645770
29,2009-10-27,Stan Helsing: A Parody,14000000,0,1553556,2009,10,-88.9,-12446444
30,2005-12-09,Brokeback Mountain,13900000,83043761,176980863,2005,12,1173.24,163080863
32,2008-12-31,Ca$h,13700000,0,11738256,2008,12,-14.32,-1961744
35,2002-11-08,Far From Heaven,13500000,15901849,29027914,2002,11,115.02,15527914
36,2012-10-12,Seven Psychopaths,13500000,15024049,33035736,2012,10,144.71,19535736
37,2000-11-22,Quills,13500000,7060876,11732088,2000,11,-13.1,-1767912
39,2005-02-18,Der Untergang,13500000,5501940,93631744,2005,2,593.57,80131744
40,2001-03-02,The Caveman's Valentine,13500000,687081,892506,2001,3,-93.39,-12607494
41,2011-04-01,The Last Godfather,13400000,164247,164247,2011,4,-98.77,-13235753
42,2014-04-04,Under the Skin,13300000,2614251,7229933,2014,4,-45.64,-6070067
43,2004-12-17,Mar adentro,13300000,2086345,39686345,2004,12,198.39,26386345
44,2014-09-12,No Good Deed,13200000,52543632,54323210,2014,9,311.54,41123210
46,2010-12-03,Black Swan,13000000,106954678,331266710,2010,12,2448.21,318266710
47,2001-01-12,Save the Last Dance,13000000,91038276,122244329,2001,1,840.34,109244329
48,2011-02-11,Justin Bieber: Never Say Never,13000000,73013910,99034125,2011,2,661.8,86034125
49,2018-07-04,The First Purge,13000000,69488745,136617305,2018,7,950.9,123617305
50,2016-03-16,Miracles from Heaven,13000000,61705123,73798736,2016,3,467.68,60798736
51,2000-02-11,Snow Day,13000000,60008303,62452927,2000,2,380.41,49452927
52,2004-01-23,The Butterfly Effect,13000000,57924679,95638592,2004,1,635.68,82638592
54,2016-06-24,The Shallows,13000000,55121623,118763442,2016,6,813.56,105763442
57,2007-11-21,This Christmas,13000000,49121934,49733545,2007,11,282.57,36733545
58,2014-02-14,About Last Night,13000000,48637684,50445860,2014,2,288.05,37445860
59,2000-12-15,"Dude, Where's My Car?",13000000,46729374,73180297,2000,12,462.93,60180297
61,2014-10-10,St. Vincent,13000000,44137712,54837234,2014,10,321.82,41837234
62,2014-07-02,Earth to Echo,13000000,38934842,42174545,2014,7,224.42,29174545
64,2002-05-10,The New Guy,13000000,28972187,28972187,2002,5,122.86,15972187
70,2013-03-01,21 and Over,13000000,25682380,42195766,2013,3,224.58,29195766
71,2007-11-21,The Mist,13000000,25593755,57189408,2007,11,339.92,44189408
72,2015-04-10,Ex Machina,13000000,25440971,38358392,2015,4,195.06,25358392
74,2001-09-07,Two Can Play That Game,13000000,22235901,22391450,2001,9,72.24,9391450
75,2016-03-11,Eye in the Sky,13000000,18704596,35402802,2016,3,172.33,22402802
76,2013-03-22,Admission,13000000,18007317,18733666,2013,3,44.11,5733666
77,2012-09-21,The Perks of Being a Wallflower,13000000,17742948,33069303,2012,9,154.38,20069303
78,2001-06-29,crazy/beautiful,13000000,16929123,19929123,2001,6,53.3,6929123
80,2015-10-16,Room,13000000,14677674,36262783,2015,10,178.94,23262783
81,2015-10-16,Woodlawn,13000000,14394097,14403703,2015,10,10.8,1403703
82,2006-12-20,Letters from Iwo Jima,13000000,13756082,67867998,2006,12,422.06,54867998
83,2009-05-29,MÃ¤n som hatar kvinnor,13000000,12749992,109421911,2009,5,741.71,96421911
84,2007-02-23,The Astronaut Farmer,13000000,11003643,11141213,2007,2,-14.3,-1858787
86,2015-07-17,Bajrangi Bhaijaan,13000000,8178001,121778347,2015,7,836.76,108778347
88,2016-09-09,Robinson Crusoe,13000000,8005586,42446455,2016,9,226.51,29446455
92,2001-08-24,Bubble Boy,13000000,5002310,5002310,2001,8,-61.52,-7997690
93,2002-02-01,Birthday Girl,13000000,4919896,8130727,2002,2,-37.46,-4869273
94,2007-05-04,"Paris, je t'aime",13000000,4857374,5175088,2007,5,-60.19,-7824912
95,2018-12-07,Ben is Back,13000000,3703182,9633111,2018,12,-25.9,-3366889
96,2007-08-24,Resurrecting the Champ,13000000,3172382,3260555,2007,8,-74.92,-9739445
97,2010-03-26,Chloe,13000000,3075255,11831131,2010,3,-8.99,-1168869
98,2001-03-02,The Widow of St. Pierre,13000000,3058380,3058380,2001,3,-76.47,-9941620
99,2015-12-04,Youth,13000000,2703296,24001573,2015,12,84.63,11001573
1,2010-02-26,Un ProphÃ¨te,13000000,2087720,19910624,2010,2,53.16,6910624
2,2010-12-03,"I Love You, Phillip Morris",13000000,2037459,23014027,2010,12,77.03,10014027
3,2015-07-24,The Vatican Tapes,13000000,1784763,14929184,2015,7,14.84,1929184
4,2006-03-17,Find Me Guilty,13000000,1173673,2898225,2006,3,-77.71,-10101775
6,2006-10-13,Infamous,13000000,1151330,2613717,2006,10,-79.89,-10386283
7,2011-07-29,Attack the Block,13000000,1024175,6459183,2011,7,-50.31,-6540817
8,2015-08-14,Brothers,13000000,656688,17856688,2015,8,37.36,4856688
9,2000-12-29,The Claim,13000000,622023,1375635,2000,12,-89.42,-11624365
10,2011-12-23,In The Land of Blood and Honey,13000000,303877,509193,2011,12,-96.08,-12490807
11,2010-06-18,The Killer Inside Me,13000000,217277,3617277,2010,6,-72.17,-9382723
14,2013-03-15,The Call,12800000,51872378,69821476,2013,3,445.48,57021476
15,2016-08-05,Operation Chromite,12700000,1022720,49196532,2016,8,287.37,36496532
16,2014-09-12,The Drop,12600000,10724389,19054534,2014,9,51.23,6454534
17,2002-07-12,The Crocodile Hunter: Collision Course,12500000,28436931,33436931,2002,7,167.5,20936931
18,2010-09-03,Machete,12500000,26593646,46370970,2010,9,270.97,33870970
19,2002-12-19,Antwone Fisher,12500000,21078145,23367586,2002,12,86.94,10867586
21,2002-11-22,The Emperor's Club,12500000,14060950,16193713,2002,11,29.55,3693713
23,2009-09-11,Sorority Row,12500000,11965282,26735797,2009,9,113.89,14235797
25,2008-11-07,The Boy in the Striped Pyjamas,12500000,9046156,44083403,2008,11,252.67,31583403
28,2010-10-15,Conviction,12500000,6797696,11826980,2010,10,-5.38,-673020
29,2007-10-12,Lars and the Real Girl,12500000,5956480,11277119,2007,10,-9.78,-1222881
30,2010-05-21,Solitary Man,12500000,4360548,4360548,2010,5,-65.12,-8139452
31,2000-09-22,Dancer in the Dark,12500000,4157491,45557491,2000,9,264.46,33057491
32,2010-12-17,Casino Jack,12500000,2039869,2272186,2010,12,-81.82,-10227814
35,2004-09-03,Tae Guik Gi: The Brotherhood of War,12500000,1110186,69826708,2004,9,458.61,57326708
36,2010-04-16,The Perfect Game,12500000,1089445,3931367,2010,4,-68.55,-8568633
37,2012-10-05,The Paperboy,12500000,677200,4027663,2012,10,-67.78,-8472337
38,2013-03-01,Ernest et Celestine,12500000,292562,9376444,2013,3,-24.99,-3123556
39,2012-05-04,A Little Bit of Heaven,12500000,10011,1100287,2012,5,-91.2,-11399713
43,2014-06-06,The Fault in Our Stars,12000000,124872350,307166834,2014,6,2459.72,295166834
45,2012-04-20,Think Like a Man,12000000,91547205,113373764,2012,4,844.78,101373764
46,2014-04-16,Heaven is for Real,12000000,91386097,100916299,2014,4,740.97,88916299
49,2002-09-13,Barbershop,12000000,75781642,77063461,2002,9,542.2,65063461
52,2012-02-24,Act of Valor,12000000,70012847,82497035,2012,2,587.48,70497035
54,2006-08-11,Step Up,12000000,65328121,110989157,2006,8,824.91,98989157
55,2012-02-03,Chronicle,12000000,64575175,123681790,2012,2,930.68,111681790
58,2012-03-02,Project X,12000000,54731865,103028188,2012,3,758.57,91028188
59,2017-11-10,"Three Billboards Outside Ebbing, Missouri",12000000,54513740,160191915,2017,11,1234.93,148191915
60,2016-11-25,Lion,12000000,51739495,149570720,2016,11,1146.42,137570720
61,2018-05-04,Overboard,12000000,50316123,85369830,2018,5,611.42,73369830
64,2008-04-25,Harold & Kumar Escape from Guantanamo Bay,12000000,38108728,43353117,2008,4,261.28,31353117
65,2013-11-22,Philomena,12000000,37709979,98963392,2013,11,724.69,86963392
67,2002-02-15,Crossroads,12000000,37188667,57000000,2002,2,375.0,45000000
68,2015-07-24,Paper Towns,12000000,32000304,85450484,2015,7,612.09,73450484
69,2008-10-10,Quarantine,12000000,31691811,41924774,2008,10,249.37,29924774
70,2002-08-21,One Hour Photo,12000000,31597131,52223306,2002,8,335.19,40223306
71,2008-02-01,The Eye,12000000,31418697,57577765,2008,2,379.81,45577765
72,2004-04-07,Johnson Family Vacation,12000000,31203964,31286759,2004,4,160.72,19286759
73,2001-12-21,How High,12000000,31155435,31222395,2001,12,160.19,19222395
75,2006-09-01,Crank,12000000,27838408,43924923,2006,9,266.04,31924923
77,2016-08-12,Hell or High Water,12000000,27007844,37584304,2016,8,213.2,25584304
78,2002-10-25,Frida,12000000,25885000,56131239,2002,10,367.76,44131239
79,2012-07-05,Katy Perry: Part of Me,12000000,25326071,32700439,2012,7,172.5,20700439
80,2014-12-12,Top Five,12000000,25317379,26001741,2014,12,116.68,14001741
84,2015-01-30,Project Almanac,12000000,22348241,32909437,2015,1,174.25,20909437
85,2010-05-14,Just Wright,12000000,21540363,21867665,2010,5,82.23,9867665
89,2005-03-11,The Upside of Anger,12000000,18761993,28915761,2005,3,140.96,16915761
90,2006-03-03,Aquamarine,12000000,18597342,22978953,2006,3,91.49,10978953
91,2013-11-15,Nebraska,12000000,17654912,24761360,2013,11,106.34,12761360
92,2004-01-09,My Baby's Daddy,12000000,17321573,17322212,2004,1,44.35,5322212
93,2001-10-05,Max Keeble's Big Move,12000000,17292381,17292381,2001,10,44.1,5292381
94,2011-12-09,Young Adult,12000000,16311571,22750356,2011,12,89.59,10750356
95,2013-11-01,About Time,12000000,15323921,89309178,2013,11,644.24,77309178
96,2018-12-14,If Beale Street Could Talk,12000000,14915773,19859167,2018,12,65.49,7859167
97,2017-07-14,Wish Upon,12000000,14301505,23477345,2017,7,95.64,11477345
100,2008-10-03,Rachel Getting Married,12000000,12796861,17475475,2008,10,45.63,5475475
2,2003-12-12,Girl with a Pearl Earring,12000000,11634362,43274797,2003,12,260.62,31274797
4,2017-04-21,Unforgettable,12000000,11368012,16221211,2017,4,35.18,4221211
5,2004-12-03,House of Flying Daggers,12000000,11050094,92863945,2004,12,673.87,80863945
6,2002-03-22,Sorority Boys,12000000,10198766,12516222,2002,3,4.3,516222
7,2017-10-13,Marshall,12000000,10051659,10116816,2017,10,-15.69,-1883184
8,2008-12-05,Cadillac Records,12000000,8195551,8942516,2008,12,-25.48,-3057484
9,2012-09-14,Arbitrage,12000000,7919574,35830713,2012,9,198.59,23830713
11,2000-05-12,Screwed,12000000,6982680,6982680,2000,5,-41.81,-5017320
12,2006-10-20,Running With Scissors,12000000,6860000,8706701,2006,10,-27.44,-3293299
14,2012-06-01,For Greater Glory: The True Story of Cristiada,12000000,5669081,10026255,2012,6,-16.45,-1973745
15,2006-11-17,For Your Consideration,12000000,5549923,5549923,2006,11,-53.75,-6450077
17,2003-06-20,From Justin to Kelly,12000000,4922166,4922166,2003,6,-58.98,-7077834
20,2003-10-22,In the Cut,12000000,4717455,23693646,2003,10,97.45,11693646
21,2008-02-22,Charlie Bartlett,12000000,3950294,5295909,2008,2,-55.87,-6704091
22,2009-02-13,Two Lovers,12000000,3149034,16349034,2009,2,36.24,4349034
23,2013-11-15,La grande bellezza,12000000,2883879,29549145,2013,11,146.24,17549145
24,2002-02-15,Last Orders,12000000,2326407,2326407,2002,2,-80.61,-9673593
25,2007-03-09,Gwoemul,12000000,2201923,92618117,2007,3,671.82,80618117
28,2002-06-14,The Dangerous Lives of Altar Boys,12000000,1779284,1779284,2002,6,-85.17,-10220716
29,2013-03-01,Stoker,12000000,1703125,12034913,2013,3,0.29,34913
30,2008-03-07,Married Life,12000000,1506998,2975188,2008,3,-75.21,-9024812
31,2005-08-05,2046,12000000,1442338,19287485,2005,8,60.73,7287485
32,2011-03-11,Kill the Irishman,12000000,1188194,1188194,2011,3,-90.1,-10811806
33,2005-09-30,Duma,12000000,870067,994790,2005,9,-91.71,-11005210
34,2012-04-20,Darling Companion,12000000,793352,1200346,2012,4,-90.0,-10799654
35,2010-06-04,Ondine,12000000,550472,557545,2010,6,-95.35,-11442455
36,2001-07-20,Brother,12000000,450594,450594,2001,7,-96.25,-11549406
37,2002-10-04,Welcome to Collinwood,12000000,378650,4606284,2002,10,-61.61,-7393716
38,2008-04-18,Life Before Her Eyes,12000000,303439,7203439,2008,4,-39.97,-4796561
40,2007-09-28,Trade,12000000,214202,1513388,2007,9,-87.39,-10486612
41,2006-01-06,Fateless,12000000,196857,196857,2006,1,-98.36,-11803143
42,2010-09-03,San qiang pai an jing qi,12000000,190946,310946,2010,9,-97.41,-11689054
44,2001-03-09,Company Man,12000000,146028,622273,2001,3,-94.81,-11377727
45,2009-11-07,Nanjing! Nanjing!,12000000,122558,20122558,2009,11,67.69,8122558
46,2015-10-09,Trash,12000000,17484,6553186,2015,10,-45.39,-5446814
47,2011-08-19,5 Days of War,12000000,17479,87793,2011,8,-99.27,-11912207
48,2015-11-11,10 Days in a Madhouse,12000000,14616,14616,2015,11,-99.88,-11985384
49,2009-04-07,1612,12000000,0,5400624,2009,4,-54.99,-6599376
50,2015-12-31,San cheng ji,12000000,0,1950194,2015,12,-83.75,-10049806
51,2011-12-31,Tu Xia Chuan Qi,12000000,0,1828400,2011,12,-84.76,-10171600
52,2010-02-10,Triangle,12000000,0,1594955,2010,2,-86.71,-10405045
57,2016-09-23,The Dressmaker,11900000,2022115,24041617,2016,9,102.03,12141617
60,2015-11-20,Carol,11800000,12711491,42843521,2015,11,263.08,31043521
62,2016-01-22,Dirty Grandpa,11500000,35593113,105078449,2016,1,813.73,93578449
64,2009-10-09,St. Trinianâs,11400000,15000,29830239,2009,10,161.67,18430239
68,2010-12-10,The Fighter,11000000,93617009,129262388,2010,12,1075.11,118262388
69,2008-10-24,High School Musical 3: Senior Year,11000000,90559416,274392880,2008,10,2394.48,263392880
71,2006-09-22,Jackass: Number Two,11000000,72778712,85278712,2006,9,675.26,74278712
73,2014-08-22,If I Stay,11000000,50474843,78356170,2014,8,612.33,67356170
75,2003-04-04,Phone Booth,11000000,46566212,97837138,2003,4,789.43,86837138
76,2002-01-25,A Walk to Remember,11000000,41227069,46060861,2002,1,318.74,35060861
79,2015-11-04,Brooklyn,11000000,38322743,62076141,2015,11,464.33,51076141
80,2008-10-17,The Secret Life of Bees,11000000,37780486,39994347,2008,10,263.58,28994347
81,2015-04-01,Woman in Gold,11000000,33307793,58586407,2015,4,432.6,47586407
83,2017-12-08,"I, Tonya",11000000,30014534,53797409,2017,12,389.07,42797409
84,2009-10-23,Saw VI,11000000,27693292,69752402,2009,10,534.11,58752402
85,2001-10-12,Corky Romano,11000000,23978402,25116103,2001,10,128.33,14116103
86,2019-02-14,Fighting With My Family,11000000,22958583,39049922,2019,2,255.0,28049922
90,2013-01-11,Quartet,11000000,18388357,56178935,2013,1,410.72,45178935
91,2001-11-21,Out Cold,11000000,13906394,14786394,2001,11,34.42,3786394
92,2000-10-13,The Ladies Man,11000000,13592872,13719474,2000,10,24.72,2719474
93,2001-03-30,Tomcats,11000000,13558739,13558739,2001,3,23.26,2558739
94,2013-12-06,Inside Llewyn Davis,11000000,13248209,32943247,2013,12,199.48,21943247
95,2002-04-12,Frailty,11000000,13110448,19947280,2002,4,81.34,8947280
97,2004-11-12,Kinsey,11000000,10214647,17443529,2004,11,58.58,6443529
98,2013-05-10,Peeples,11000000,9177065,9307166,2013,5,-15.39,-1692834
100,2016-07-06,Sultan,11000000,5599781,72989781,2016,7,563.54,61989781
1,2002-02-01,Slackers,11000000,4814244,5942218,2002,2,-45.98,-5057782
2,2003-09-26,The Gospel of John,11000000,4068087,4234355,2003,9,-61.51,-6765645
3,2004-10-10,Vera Drake,11000000,3753806,13353855,2004,10,21.4,2353855
4,2003-01-31,The Guru,11000000,3051221,24150550,2003,1,119.55,13150550
9,2007-09-07,Romance and Cigarettes,11000000,551002,3231251,2007,9,-70.62,-7768749
10,2006-11-10,Copying Beethoven,11000000,355968,6586324,2006,11,-40.12,-4413676
11,2011-08-26,Brighton Rock,11000000,229653,229653,2011,8,-97.91,-10770347
12,2012-11-16,Le prÃ©nom,11000000,61611,25307405,2012,11,130.07,14307405
13,2015-05-08,La famille BÃ©lier,11000000,0,82438670,2015,5,649.44,71438670
14,2012-05-04,LOL,11000000,0,10431506,2012,5,-5.17,-568494
15,2016-02-05,Misconduct,11000000,0,2352511,2016,2,-78.61,-8647489
17,2008-10-24,Saw V,10800000,56746769,118209778,2008,10,994.53,107409778
18,2012-05-25,Les Intouchables,10800000,13182281,484873045,2012,5,4389.57,474073045
19,2007-04-27,Jindabyne,10800000,399879,2862544,2007,4,-73.49,-7937456
20,2006-08-11,Kabhi Alvida Naa Kehna,10750000,3275443,32575443,2006,8,203.03,21825443
24,2004-12-25,Darkness,10600000,22163442,34409206,2004,12,224.62,23809206
25,2013-12-06,The Last Days on Mars,10600000,24084,261364,2013,12,-97.53,-10338636
28,2007-04-20,In the Land of Women,10500000,11052958,14140402,2007,4,34.67,3640402
30,2004-02-20,The Blue Butterfly,10400000,1610194,1610194,2004,2,-84.52,-8789806
31,2001-11-02,Le Fabuleux destin d'AmÃ©lie Poulain,10350000,33201661,174201661,2001,11,1583.11,163851661
32,2019-01-04,PMC: deo beong-keo,10300000,0,12478635,2019,1,21.15,2178635
34,2010-04-30,Housefull,10100000,1183658,18726300,2010,4,85.41,8626300
35,2007-08-24,September Dawn,10100000,1066555,1066555,2007,8,-89.44,-9033445
36,2018-10-19,Halloween,10000000,159342015,254900667,2018,10,2449.01,244900667
38,2004-10-22,The Grudge,10000000,110359362,187281115,2004,10,1772.81,177281115
39,2016-08-26,Donât Breathe,10000000,89217875,158973685,2016,8,1489.74,148973685
41,2006-10-27,Saw III,10000000,80238724,163876815,2006,10,1538.77,153876815
42,2016-07-01,The Purge: Election Year,10000000,79042440,118514727,2016,7,1085.15,108514727
43,2018-05-18,Book Club,10000000,68566296,91113683,2018,5,811.14,81113683
44,2000-08-25,Bring it On,10000000,68353550,90453550,2000,8,804.54,80453550
45,2018-01-05,Insidious: The Last Key,10000000,67745330,167885588,2018,1,1578.86,157885588
47,2007-10-26,Saw IV,10000000,63300095,135759694,2007,10,1257.6,125759694
48,2006-02-24,Madea's Family Reunion,10000000,63257940,63320521,2006,2,533.21,53320521
49,2005-01-07,White Noise,10000000,56094360,92094360,2005,1,820.94,82094360
51,2015-06-05,Insidious Chapter 3,10000000,52218558,120453155,2015,6,1104.53,110453155
53,2017-11-03,Lady Bird,10000000,48958273,78610769,2017,11,686.11,68610769
54,2009-11-06,Precious (Based on the Novel Push by Sapphire),10000000,47566524,68722848,2009,11,587.23,58722848
55,2012-05-04,The Best Exotic Marigold Hotel,10000000,46383639,134639780,2012,5,1246.4,124639780
56,2018-06-08,Hereditary,10000000,44069456,70133905,2018,6,601.34,60133905
57,2018-03-16,"Love, Simon",10000000,40826341,65520633,2018,3,555.21,55520633
61,2017-10-27,Jigsaw,10000000,38052832,102445196,2017,10,924.45,92445196
62,2001-08-31,Jeepers Creepers,10000000,37904175,58939035,2001,8,489.39,48939035
65,2001-02-16,Recess: School's Out,10000000,36696761,44451470,2001,2,344.51,34451470
68,2016-01-22,The Boy,10000000,35819556,68220952,2016,1,582.21,58220952
70,2017-05-19,"Everything, Everything",10000000,34121140,61603136,2017,5,516.03,51603136
71,2010-09-17,Devil,10000000,33679655,63354114,2010,9,533.54,53354114
72,2002-11-22,Friday After Next,10000000,33253609,33526835,2002,11,235.27,23526835
73,2015-03-06,The Second Best Exotic Marigold Hotel,10000000,33078266,90384306,2015,3,803.84,80384306
75,2017-04-28,How to Be a Latin Lover,10000000,32149404,62556228,2017,4,525.56,52556228
77,2008-10-03,Nick and Norah's Infinite Playlist,10000000,31487293,33886017,2008,10,238.86,23886017
78,2003-12-19,Calendar Girls,10000000,31011616,93074616,2003,12,830.75,83074616
80,2018-08-10,Slender Man,10000000,30564825,51723644,2018,8,417.24,41723644
81,2002-09-20,The Banger Sisters,10000000,30306281,38067218,2002,9,280.67,28067218
82,2000-12-08,Snatch,10000000,30093107,83593107,2000,12,735.93,73593107
84,2018-07-27,Teen Titans Go! To The Movies,10000000,29790236,51620593,2018,7,416.21,41620593
85,2016-09-09,When the Bough Breaks,10000000,29747603,30768449,2016,9,207.68,20768449
88,2013-08-30,One Direction: This is Us,10000000,28873374,68541786,2013,8,585.42,58541786
89,2002-09-06,Swimfan,10000000,28564995,34084228,2002,9,240.84,24084228
90,2006-10-06,Employee of the Month,10000000,28444855,38364855,2006,10,283.65,28364855
91,2015-08-21,Sinister 2,10000000,27740955,54104225,2015,8,441.04,44104225
92,2016-01-08,The Forest,10000000,26594261,40749230,2016,1,307.49,30749230
93,2009-11-06,The Fourth Kind,10000000,26218170,49486874,2009,11,394.87,39486874
96,2012-08-17,Sparkle,10000000,24397469,24660323,2012,8,146.6,14660323
97,2016-10-14,Kevin Hart: What Now?,10000000,23591043,23591043,2016,10,135.91,13591043
98,2013-04-26,Mud,10000000,21590086,31556959,2013,4,215.57,21556959
99,2010-11-12,Skyline,10000000,21416355,68264973,2010,11,582.65,58264973
100,2017-12-01,The Disaster Artist,10000000,21120616,28717667,2017,12,187.18,18717667
1,2016-09-16,Blair Witch,10000000,20777061,38985577,2016,9,289.86,28985577
3,2001-02-02,Valentine,10000000,20384136,20384136,2001,2,103.84,10384136
4,2006-06-09,A Prairie Home Companion,10000000,20342852,26716191,2006,6,167.16,16716191
5,2007-02-23,Reno 911!: Miami,10000000,20342161,21851362,2007,2,118.51,11851362
7,2015-10-23,Paranormal Activity: The Ghost Dimension,10000000,18297124,77959374,2015,10,679.59,67959374
9,2008-06-20,Kit Kittredge: An American Girl,10000000,17657973,17657973,2008,6,76.58,7657973
11,2005-09-23,Roll Bounce,10000000,17380866,17433072,2005,9,74.33,7433072
14,2005-06-17,The Perfect Man,10000000,16535005,19535005,2005,6,95.35,9535005
16,2002-01-25,Kung Pow: Enter the Fist,10000000,16033556,17033556,2002,1,70.34,7033556
17,2016-10-07,The Birth of a Nation,10000000,15861566,16891011,2016,10,68.91,6891011
18,2003-05-30,Wrong Turn,10000000,15417771,28649556,2003,5,186.5,18649556
21,2009-08-14,"The Goods: Live Hard, Sell Hard",10000000,15122676,15297318,2009,8,52.97,5297318
22,2011-11-23,My Week with Marilyn,10000000,14597405,34240572,2011,11,242.41,24240572
23,2014-12-25,Big Eyes,10000000,14482031,27317872,2014,12,173.18,17317872
24,2005-08-05,Broken Flowers,10000000,13744960,40744960,2005,8,307.45,30744960
25,2002-06-28,Hey Arnold! The Movie,10000000,13684949,13684949,2002,6,36.85,3684949
26,2005-12-30,The Matador,10000000,12589255,17300838,2005,12,73.01,7300838
28,2000-12-19,The Gift,10000000,12008642,44567606,2000,12,345.68,34567606
29,2006-01-20,End of the Spear,10000000,11748661,11924041,2006,1,19.24,1924041
30,2001-03-09,Get Over It,10000000,11560259,19860259,2001,3,98.6,9860259
31,2000-10-20,The Legend of Drunken Master,10000000,11546543,11546543,2000,10,15.47,1546543
34,2019-04-05,The Best of Enemies,10000000,10205616,10205616,2019,4,2.06,205616
38,2004-07-09,Sleepover,10000000,9408183,9408183,2004,7,-5.92,-591817
39,2013-01-25,Movie 43,10000000,8840453,31164747,2013,1,211.65,21164747
40,2018-10-19,Can You Ever Forgive Me?,10000000,8803865,11752387,2018,10,17.52,1752387
42,2010-05-21,MacGruber,10000000,8525600,8629895,2010,5,-13.7,-1370105
43,2003-07-18,Dirty Pretty Things,10000000,8112414,14156753,2003,7,41.57,4156753
44,2014-03-14,Bad Words,10000000,7779614,7843145,2014,3,-21.57,-2156855
45,2015-03-27,While We're Young,10000000,7582065,17503828,2015,3,75.04,7503828
46,2008-02-01,Over Her Dead Body,10000000,7570127,21596074,2008,2,115.96,11596074
47,2001-10-24,Bones,10000000,7316658,8378853,2001,10,-16.21,-1621147
48,2012-06-22,Seeking a Friend for the End of the World,10000000,7078738,11766959,2012,6,17.67,1766959
49,2006-12-01,Turistas,10000000,7027762,14321070,2006,12,43.21,4321070
50,2016-11-11,Shut In,10000000,6900335,11360665,2016,11,13.61,1360665
51,2011-02-11,Cedar Rapids,10000000,6861102,7862131,2011,2,-21.38,-2137869
52,2012-11-30,The Collection,10000000,6810754,8890094,2012,11,-11.1,-1109906
54,2004-01-16,Teacher's Pet: The Movie,10000000,6491969,6491969,2004,1,-35.08,-3508031
56,2002-05-03,Deuces Wild,10000000,6044618,6244618,2002,5,-37.55,-3755382
57,2008-03-28,"Run, Fatboy, Run",10000000,6003262,33512260,2008,3,235.12,23512260
59,2015-03-20,Danny Collins,10000000,5637066,8465845,2015,3,-15.34,-1534155
60,2007-07-04,Rescue Dawn,10000000,5490423,7037886,2007,7,-29.62,-2962114
61,2000-04-05,Black and White,10000000,5241315,5241315,2000,4,-47.59,-4758685
62,2010-06-18,Io sono lâamore,10000000,5005465,15121528,2010,6,51.22,5121528
63,2001-10-26,On the Line,10000000,4365455,4690802,2001,10,-53.09,-5309198
64,2018-06-15,Gotti,10000000,4286367,6089100,2018,6,-39.11,-3910900
65,2012-03-16,"Jeff, Who Lives at Home",10000000,4269426,4708127,2012,3,-52.92,-5291873
66,2016-09-30,Denial,10000000,4073448,9263940,2016,9,-7.36,-736060
67,2016-04-29,The Man Who Knew Infinity,10000000,3877922,12382122,2016,4,23.82,2382122
68,2016-10-14,Max Steel,10000000,3818664,4563080,2016,10,-54.37,-5436920
69,2016-03-30,Everybody Wants Some,10000000,3400278,5437126,2016,3,-45.63,-4562874
71,2012-10-12,Atlas Shrugged: Part II,10000000,3336053,3336053,2012,10,-66.64,-6663947
74,2014-11-14,Rosewater,10000000,3128941,3185717,2014,11,-68.14,-6814283
75,2000-12-22,The House of Mirth,10000000,3041803,5149131,2000,12,-48.51,-4850869
77,2006-06-02,Peaceful Warrior,10000000,2893666,3260179,2006,6,-67.4,-6739821
78,2011-09-09,Bucky Larson: Born to Be a Star,10000000,2529395,2529395,2011,9,-74.71,-7470605
79,2000-10-06,Bamboozled,10000000,2185266,2373937,2000,10,-76.26,-7626063
81,2013-05-03,The Iceman,10000000,1930282,3623609,2013,5,-63.76,-6376391
82,2015-06-05,Testament of Youth,10000000,1822250,6646669,2015,6,-33.53,-3353331
83,2017-04-21,Free Fire,10000000,1799322,3793739,2017,4,-62.06,-6206261
84,2011-06-24,A Better Life,10000000,1759252,1884251,2011,6,-81.16,-8115749
85,2003-02-28,Spider,10000000,1641788,1641788,2003,2,-83.58,-8358212
86,2000-02-04,Gun Shy,10000000,1638202,1638202,2000,2,-83.62,-8361798
87,2002-12-27,Nicholas Nickleby,10000000,1562800,1562800,2002,12,-84.37,-8437200
88,2010-04-16,The Joneses,10000000,1475746,3541565,2010,4,-64.58,-6458435
89,2006-06-23,Krrish,10000000,1430721,32430721,2006,6,224.31,22430721
90,2012-07-27,Killer Joe,10000000,1291645,4659110,2012,7,-53.41,-5340890
91,2017-06-02,Churchill,10000000,1279681,7582196,2017,6,-24.18,-2417804
92,2000-08-11,Cecil B. Demented,10000000,1276984,1953882,2000,8,-80.46,-8046118
93,2014-03-21,50 to 1,10000000,1069454,1069454,2014,3,-89.31,-8930546
94,2003-05-02,Owning Mahowny,10000000,1011054,1011054,2003,5,-89.89,-8988946
95,2007-10-19,The Ten Commandments,10000000,952820,1051907,2007,10,-89.48,-8948093
96,2007-09-07,The Brothers Solomon,10000000,900926,900926,2007,9,-90.99,-9099074
97,2008-04-04,My Blueberry Nights,10000000,866778,22198996,2008,4,121.99,12198996
99,2012-01-20,Coriolanus,10000000,749641,2179623,2012,1,-78.2,-7820377
100,2013-10-04,Parkland,10000000,641439,1616353,2013,10,-83.84,-8383647
1,2002-10-11,Swept Away,10000000,598645,598645,2002,10,-94.01,-9401355
2,2008-05-23,"War, Inc.",10000000,580862,1299855,2008,5,-87.0,-8700145
3,2004-04-02,Shaolin Soccer,10000000,488872,42776032,2004,4,327.76,32776032
4,2004-08-27,The Brown Bunny,10000000,366301,630427,2004,8,-93.7,-9369573
5,2007-09-14,King of California,10000000,268461,1165102,2007,9,-88.35,-8834898
8,2004-12-17,Imaginary Heroes,10000000,228524,290875,2004,12,-97.09,-9709125
9,2001-10-26,High Heels and Low Lifes,10000000,226792,226792,2001,10,-97.73,-9773208
10,2009-08-21,World's Greatest Dad,10000000,221805,295750,2009,8,-97.04,-9704250
11,2013-05-03,"Cinco de Mayo, La Batalla",10000000,173472,173472,2013,5,-98.27,-9826528
12,2010-10-29,Welcome to the Rileys,10000000,152857,355919,2010,10,-96.44,-9644081
13,2016-09-09,Kicks,10000000,150191,150191,2016,9,-98.5,-9849809
14,2009-10-09,Free Style,10000000,141108,721108,2009,10,-92.79,-9278892
15,2012-06-01,High School,10000000,139034,248133,2012,6,-97.52,-9751867
16,2007-05-18,Severance,10000000,137221,5950002,2007,5,-40.5,-4049998
17,2006-07-14,Edmond,10000000,131719,241719,2006,7,-97.58,-9758281
18,2010-04-23,Joheunnom nabbeunnom isanghannom,10000000,128486,42226657,2010,4,322.27,32226657
20,2010-02-19,Blood Done Sign My Name,10000000,109383,109383,2010,2,-98.91,-9890617
21,2010-02-19,The Good Guy,10000000,100688,106460,2010,2,-98.94,-9893540
22,2009-10-23,Motherhood,10000000,93388,723388,2009,10,-92.77,-9276612
23,2004-10-15,Eulogy,10000000,70527,70527,2004,10,-99.29,-9929473
24,2014-11-07,Elsa & Fred,10000000,67657,197901,2014,11,-98.02,-9802099
26,2009-08-28,The Open Road,10000000,19716,19716,2009,8,-99.8,-9980284
27,2015-07-10,Strangerland,10000000,17472,161097,2015,7,-98.39,-9838903
28,2015-03-13,Hross i oss,10000000,11894,11894,2015,3,-99.88,-9988106
29,2009-10-16,Janky Promoters,10000000,9069,9069,2009,10,-99.91,-9990931
30,2007-12-21,Blonde Ambition,10000000,6422,1537479,2007,12,-84.63,-8462521
31,2010-08-06,The Oxford Murders,10000000,4803,17704131,2010,8,77.04,7704131
32,2014-12-26,Barbecue,10000000,388,247565,2014,12,-97.52,-9752435
33,2010-12-31,The Reef,10000000,0,15037867,2010,12,50.38,5037867
34,2008-01-08,White Noise 2: The Light,10000000,0,8243567,2008,1,-17.56,-1756433
35,2015-07-21,American Heist,10000000,0,2341218,2015,7,-76.59,-7658782
36,2010-10-08,It's a Wonderful Afterlife,10000000,0,1642939,2010,10,-83.57,-8357061
37,2011-06-21,You Got Served: Beat The World,10000000,0,1230542,2011,6,-87.69,-8769458
38,2009-08-21,Fifty Dead Men Walking,10000000,0,997921,2009,8,-90.02,-9002079
39,2014-09-26,Plastic,10000000,0,575371,2014,9,-94.25,-9424629
40,2015-03-10,Jungle Shuffle,10000000,0,360898,2015,3,-96.39,-9639102
41,2009-09-22,Adam Resurrected,10000000,0,90909,2009,9,-99.09,-9909091
48,2017-09-22,Friend Request,9900000,3759078,11310835,2017,9,14.25,1410835
49,2010-04-30,Gunless,9900000,458054,458054,2010,4,-95.37,-9441946
50,2009-04-03,Adventureland,9800000,16044025,17553055,2009,4,79.11,7753055
51,2012-12-19,Amour,9700000,6738954,36787044,2012,12,279.25,27087044
52,2006-04-28,The Lost City,9600000,2484186,5256839,2006,4,-45.24,-4343161
53,2000-01-12,Next Friday,9500000,57176582,59675307,2000,1,528.16,50175307
56,2016-12-21,Dangal,9500000,12391761,294654618,2016,12,3001.63,285154618
57,2010-03-19,The Runaways,9500000,3573673,5278632,2010,3,-44.44,-4221368
58,2009-10-30,Gentlemen Broncos,9500000,115155,119955,2009,10,-98.74,-9380045
61,2006-11-03,Volver,9400000,12899867,87226613,2006,11,827.94,77826613
62,2011-11-11,Melancholia,9400000,3030848,21817298,2011,11,132.1,12417298
64,2012-11-13,Jab Tak Hai Jaan,9200000,3047539,5806666,2012,11,-36.88,-3393334
66,2010-05-21,Kites,9200000,1685269,17155193,2010,5,86.47,7955193
67,2011-12-31,Red Dog,9100000,0,20927794,2011,12,129.98,11827794
68,2010-12-31,Mine Vaganti,9100000,0,18872126,2010,12,107.39,9772126
69,2003-10-17,The Texas Chainsaw Massacre,9000000,80571655,107967319,2003,10,1099.64,98967319
71,2014-07-18,The Purge: Anarchy,9000000,71562550,111534881,2014,7,1139.28,102534881
73,2008-05-30,The Strangers,9000000,52597610,83051676,2008,5,822.8,74051676
75,2016-10-21,Ouija: Origin of Evil,9000000,35144505,81831866,2016,10,809.24,72831866
78,2019-02-13,Happy Death Day 2U,9000000,28051045,64179495,2019,2,613.11,55179495
79,2007-06-22,Sicko,9000000,24538513,36535837,2007,6,305.95,27535837
80,2015-01-30,Black or White,9000000,21571189,21971021,2015,1,144.12,12971021
81,2000-01-21,Down to You,9000000,20035310,20035310,2000,1,122.61,11035310
82,2004-07-30,Harold & Kumar Go to White Castle,9000000,18225165,18225165,2004,7,102.5,9225165
83,2000-10-13,The Contender,9000000,17804273,17804273,2000,10,97.83,8804273
84,2000-02-18,Boiler Room,9000000,16963963,28773637,2000,2,219.71,19773637
85,2006-12-05,Black Christmas,9000000,16235738,16235738,2006,12,80.4,7235738
86,2016-11-18,The Edge of Seventeen,9000000,14431633,19096003,2016,11,112.18,10096003
87,2016-12-02,Jackie,9000000,13960394,36588512,2016,12,306.54,27588512
89,2004-05-14,Breakin' All the Rules,9000000,12232382,12512317,2004,5,39.03,3512317
90,2011-08-12,Glee: The 3D Concert Movie,9000000,11862398,17462398,2011,8,94.03,8462398
92,2016-11-04,Loving,9000000,7710234,12898064,2016,11,43.31,3898064
93,2007-11-28,The Savages,9000000,6623082,10642023,2007,11,18.24,1642023
94,2003-04-16,Chasing Papi,9000000,6126237,12657377,2003,4,40.64,3657377
95,2000-09-08,The Way of the Gun,9000000,6047856,13061935,2000,9,45.13,4061935
96,2019-05-17,The Sun is Also a Star,9000000,4950029,5434029,2019,5,-39.62,-3565971
97,2008-08-22,Hamlet 2,9000000,4886216,4934104,2008,8,-45.18,-4065896
98,2002-09-13,Igby Goes Down,9000000,4777465,4777465,2002,9,-46.92,-4222535
100,2007-03-09,The Ultimate Gift,9000000,3438735,3438735,2007,3,-61.79,-5561265
1,2000-09-29,Beautiful,9000000,3134509,3134509,2000,9,-65.17,-5865491
2,2007-06-01,Gracie,9000000,2956339,3922043,2007,6,-56.42,-5077957
3,2013-03-22,The Sapphires,9000000,2450867,20395040,2013,3,126.61,11395040
4,2016-08-26,Greater,9000000,2000093,2000093,2016,8,-77.78,-6999907
5,2018-12-25,Destroyer,9000000,1533324,3681096,2018,12,-59.1,-5318904
6,2006-08-18,Trust the Man,9000000,1530535,2548378,2006,8,-71.68,-6451622
7,2005-08-26,Undiscovered,9000000,1069318,1069318,2005,8,-88.12,-7930682
9,2010-05-14,Princess Kaiulani,9000000,883887,883887,2010,5,-90.18,-8116113
10,2003-06-20,The Legend of Suriyothai,9000000,454255,454255,2003,6,-94.95,-8545745
12,2016-05-06,Dheepan,9000000,248795,7704357,2016,5,-14.4,-1295643
13,2010-01-22,La fille du RER,9000000,208163,208163,2010,1,-97.69,-8791837
14,2002-10-25,All or Nothing,9000000,184255,184255,2002,10,-97.95,-8815745
15,2010-02-05,Red Riding: The Year of Our Lord 1974,9000000,148826,148826,2010,2,-98.35,-8851174
16,2009-07-31,Flammen og Citronen,9000000,148089,1635241,2009,7,-81.83,-7364759
17,2010-04-02,Leaves of Grass,9000000,70066,85527,2010,4,-99.05,-8914473
18,2006-11-22,Opal Dream,9000000,14443,14443,2006,11,-99.84,-8985557
19,2015-05-08,Skin Trade,9000000,1242,1242,2015,5,-99.99,-8998758
20,2014-06-17,Beneath Hill 60,9000000,0,3440939,2014,6,-61.77,-5559061
21,2015-01-20,Veronika Decides to Die,9000000,0,2243,2015,1,-99.98,-8997757
24,2012-05-18,Polisse,8900000,176988,22744132,2012,5,155.55,13844132
25,2015-11-13,Heist,8900000,50136,3324131,2015,11,-62.65,-5575869
29,2007-11-30,Awake,8600000,14373825,32968648,2007,11,283.36,24368648
30,2016-11-18,Manchester by the Sea,8500000,47695371,77733867,2016,11,814.52,69233867
31,2009-12-16,Crazy Heart,8500000,39471742,47417251,2009,12,457.85,38917251
32,2008-08-15,Star Wars: The Clone Wars,8500000,35161554,68695443,2008,8,708.18,60195443
33,2015-02-20,The DUFF,8500000,34030343,43528634,2015,2,412.1,35028634
34,2014-10-31,Nightcrawler,8500000,32381218,50334418,2014,10,492.17,41834418
36,2019-01-16,Dragon Ball Super: Broly,8500000,30376755,122747755,2019,1,1344.09,114247755
38,2013-09-27,Baggage Claim,8500000,21569509,22885836,2013,9,169.25,14385836
39,2016-10-07,Middle School: The Worst Years of My Life,8500000,20007149,23311293,2016,10,174.25,14811293
42,2007-03-09,The Namesake,8500000,13610521,20288774,2007,3,138.69,11788774
43,2013-10-18,All is Lost,8500000,6263670,10386814,2013,10,22.2,1886814
44,2004-02-27,Club Dread,8500000,5001655,7573551,2004,2,-10.9,-926449
45,2009-09-17,Bright Star,8500000,4444637,17220091,2009,9,102.59,8720091
46,2001-09-21,Glitter,8500000,4273372,4273372,2001,9,-49.73,-4226628
47,2014-06-13,The Rover,8500000,1109199,3180252,2014,6,-62.59,-5319748
48,2004-04-23,Silmido,8500000,298347,30298347,2004,4,256.45,21798347
49,2008-11-07,Repo! The Genetic Opera,8500000,140244,198883,2008,11,-97.66,-8301117
50,2017-12-31,Posledniy bogatyr,8500000,0,30700192,2017,12,261.18,22200192
51,2016-11-01,A.C.O.R.N.S.: Operation Crackdown,8500000,0,1353287,2016,11,-84.08,-7146713
52,2010-02-12,My Name is Khan,8470000,4046336,42355526,2010,2,400.07,33885526
53,2007-03-23,Namastey London,8400000,1207007,6831069,2007,3,-18.68,-1568931
54,2013-05-31,Yeh Jawaani Hai Deewani,8300000,3827466,50827466,2013,5,512.38,42527466
56,2007-03-16,The Wind That Shakes the Barley,8300000,1829142,25670174,2007,3,209.28,17370174
57,2010-04-16,The City of Your Final Destination,8300000,493296,1353296,2010,4,-83.7,-6946704
58,2006-11-24,Kurtlar vadisi - Irak,8300000,0,24906717,2006,11,200.08,16606717
66,2006-07-26,Little Miss Sunshine,8000000,59891098,100642353,2006,7,1158.03,92642353
67,2010-09-17,Easy A,8000000,58401464,76200721,2010,9,852.51,68200721
69,2003-06-27,28 Days Laterâ¦,8000000,45064915,82955633,2003,6,936.95,74955633
71,2004-01-30,You Got Served,8000000,40066497,50811858,2004,1,535.15,42811858
72,2019-05-03,The Intruder,8000000,35095904,36005871,2019,5,350.07,28005871
73,2011-09-30,50/50,8000000,35016118,41334735,2011,9,416.68,33334735
75,2015-09-02,A Walk in the Woods,8000000,29499394,37119358,2015,9,363.99,29119358
76,2002-10-11,Brown Sugar,8000000,27362712,28315272,2002,10,253.94,20315272
78,2014-01-31,That Awkward Moment,8000000,26068955,53068955,2014,1,563.36,45068955
79,2008-03-21,Shutter,8000000,25928550,47782426,2008,3,497.28,39782426
85,2006-04-28,Akeelah and the Bee,8000000,18848430,18959424,2006,4,136.99,10959424
88,2013-09-18,Enough Said,8000000,17550872,25621449,2013,9,220.27,17621449
90,2009-01-30,New in Town,8000000,16734283,29937909,2009,1,274.22,21937909
91,2014-06-27,Begin Again,8000000,16170632,68838736,2014,6,760.48,60838736
92,2000-04-14,American Psycho,8000000,15070285,34270285,2000,4,328.38,26270285
93,2006-05-19,See No Evil,8000000,15032800,18828036,2006,5,135.35,10828036
94,2002-08-07,The Good Girl,8000000,14018296,16585503,2002,8,107.32,8585503
95,2006-08-04,"Bon Cop, Bad Cop",8000000,12671300,12740705,2006,8,59.26,4740705
96,2009-10-30,The Boondock Saints 2: All Saints Day,8000000,10273187,10629320,2009,10,32.87,2629320
97,2011-04-29,Prom,8000000,10130219,10763183,2011,4,34.54,2763183
99,2000-12-29,Shadow of the Vampire,8000000,8279017,8279017,2000,12,3.49,279017
100,2015-06-12,Me and Earl and the Dying Girl,8000000,6758416,9266180,2015,6,15.83,1266180
1,2010-10-08,It's Kind of a Funny Story,8000000,6363628,6632950,2010,10,-17.09,-1367050
3,2000-09-22,Woman on Top,8000000,5018450,10192613,2000,9,27.41,2192613
4,2000-05-12,Held Up,8000000,4714090,4714090,2000,5,-41.07,-3285910
5,2016-09-02,Morgan,8000000,3915251,7298786,2016,9,-8.77,-701214
6,2015-12-30,Anomalisa,8000000,3759286,5706168,2015,12,-28.67,-2293832
7,2005-12-23,CachÃ©,8000000,3647381,19891331,2005,12,148.64,11891331
8,2010-12-29,Another Year,8000000,3205706,20005613,2010,12,150.07,12005613
9,2002-09-20,8 femmes,8000000,3076425,42376425,2002,9,429.71,34376425
12,2013-12-20,Le passÃ©,8000000,1335672,15752575,2013,12,96.91,7752575
13,2018-04-06,Lean on Pete,8000000,1163056,2455027,2018,4,-69.31,-5544973
14,2010-11-19,Made in Dagenham,8000000,1095369,15644196,2010,11,95.55,7644196
15,2008-06-06,And When Did You Last See Your Father?,8000000,1071240,2476491,2008,6,-69.04,-5523509
16,2019-05-03,El Chicano,8000000,700261,700261,2019,5,-91.25,-7299739
17,2010-03-05,The Secret of Kells,8000000,690290,3582797,2010,3,-55.22,-4417203
20,2006-05-05,Down in the Valley,8000000,568932,973443,2006,5,-87.83,-7026557
21,2007-05-11,Brooklyn Rules,8000000,458232,458232,2007,5,-94.27,-7541768
22,2003-10-24,The Singing Detective,8000000,336456,524747,2003,10,-93.44,-7475253
23,2007-06-15,Fido,8000000,298110,456814,2007,6,-94.29,-7543186
24,2018-10-26,London Fields,8000000,252676,433732,2018,10,-94.58,-7566268
25,2011-09-16,Restless,8000000,163753,2772511,2011,9,-65.34,-5227489
27,2007-05-18,The Wendell Baker Story,8000000,127188,127188,2007,5,-98.41,-7872812
28,2010-10-29,Wild Target,8000000,109338,5314194,2010,10,-33.57,-2685806
29,2008-04-18,Pathology,8000000,109045,3270974,2008,4,-59.11,-4729026
30,2012-10-05,Wuthering Heights,8000000,100915,2721534,2012,10,-65.98,-5278466
31,2016-11-18,A Street Cat Named Bob,8000000,82703,17382693,2016,11,117.28,9382693
32,2006-08-18,10th & Wolf,8000000,54702,143782,2006,8,-98.2,-7856218
33,2015-05-22,Aloft,8000000,53086,237688,2015,5,-97.03,-7762312
34,2011-10-14,Fireflies in the Garden,8000000,36884,3587191,2011,10,-55.16,-4412809
35,2005-09-23,Dear Wendy,8000000,23106,446438,2005,9,-94.42,-7553562
36,2001-04-27,Akira,8000000,19585,19585,2001,4,-99.76,-7980415
37,2005-12-31,Welcome to Dongmakgol,8000000,0,48000000,2005,12,500.0,40000000
38,2013-09-20,Feichang Xingyun,8000000,0,21970000,2013,9,174.62,13970000
39,2017-09-29,"Don Gato, el inicio de la pandilla",8000000,0,4604656,2017,9,-42.44,-3395344
40,2007-09-04,The Death and Life of Bobby Z,8000000,0,414617,2007,9,-94.82,-7585383
41,2018-04-24,Backstabbing For Beginners,8000000,0,343773,2018,4,-95.7,-7656227
42,2014-08-12,Swelter,8000000,0,44197,2014,8,-99.45,-7955803
49,2006-01-27,Imagine Me & You,7900000,672243,3129471,2006,1,-60.39,-4770529
50,2003-07-04,Swimming Pool,7800000,10130108,24021282,2003,7,207.97,16221282
52,2015-04-14,Loin des hommes,7700000,5336,1080428,2015,4,-85.97,-6619572
55,2009-07-17,(500) Days of Summer,7500000,32425665,34439060,2009,7,359.19,26939060
57,2006-03-17,Thank You For Smoking,7500000,24793509,40016662,2006,3,433.56,32516662
58,2007-06-08,Hostel: Part II,7500000,17544812,33606409,2007,6,348.09,26106409
59,2009-10-09,An Education,7500000,12574914,29652736,2009,10,295.37,22152736
60,2009-09-04,Extract,7500000,10823158,10849158,2009,9,44.66,3349158
61,2002-12-20,Narc,7500000,10465659,11843260,2002,12,57.91,4343260
62,2005-10-21,Shopgirl,7500000,10284523,11758418,2005,10,56.78,4258418
64,2002-03-08,Men with Brooms,7500000,4239767,4239767,2002,3,-43.47,-3260233
65,2008-02-22,Witless Protection,7500000,4151836,4151836,2008,2,-44.64,-3348164
66,2004-11-24,The Work and the Glory,7500000,3347647,3347647,2004,11,-55.36,-4152353
67,2011-12-21,Albert Nobbs,7500000,3014696,8539003,2011,12,13.85,1039003
68,2016-06-24,The Neon Demon,7500000,1333124,3559803,2016,6,-52.54,-3940197
69,2003-07-24,Masked and Anonymous,7500000,533344,555335,2003,7,-92.6,-6944665
70,2018-04-13,Borg vs McEnroe,7500000,231346,3257922,2018,4,-56.56,-4242078
71,2002-09-13,Betty Fisher et autres histoires,7500000,206400,206400,2002,9,-97.25,-7293600
72,2004-08-06,Code 46,7500000,197148,1788324,2004,8,-76.16,-5711676
73,2001-12-31,The Hole,7500000,0,10834406,2001,12,44.46,3334406
74,2015-01-09,Black November,7500000,0,32572,2015,1,-99.57,-7467428
75,2015-02-24,Outside Bet,7500000,0,13524,2015,2,-99.82,-7486476
77,2017-01-13,The Bye Bye Man,7400000,22395806,31187727,2017,1,321.46,23787727
78,2007-04-27,Ta Ra Rum Pum,7400000,872643,9443864,2007,4,27.62,2043864
79,2005-05-06,Crash,7303082,55334418,101173038,2005,5,1285.35,93869956
80,2007-12-25,Persepolis,7300000,4443403,25397187,2007,12,247.91,18097187
81,2010-04-30,Harry Brown,7300000,1818681,12023606,2010,4,64.71,4723606
82,2011-05-27,Die Welle,7250000,0,35122948,2011,5,384.45,27872948
85,2011-09-16,3,7200000,59774,295492,2011,9,-95.9,-6904508
86,2007-12-05,Juno,7000000,143495265,231450102,2007,12,3206.43,224450102
88,2012-06-29,Magic Mike,7000000,113721571,170549753,2012,6,2336.43,163549753
90,2018-03-16,I Can Only Imagine,7000000,83482352,85604221,2018,3,1122.92,78604221
91,2019-03-15,Five Feet Apart,7000000,45729221,80504421,2019,3,1050.06,73504421
93,2011-05-06,Jumping the Broom,7000000,37295394,38158601,2011,5,445.12,31158601
95,2000-01-12,My Dog Skip,7000000,34099640,35795319,2000,1,411.36,28795319
96,2003-01-24,Darkness Falls,7000000,32539681,47289758,2003,1,575.57,40289758
97,2008-02-14,"Definitely, Maybe",7000000,32241649,55617866,2008,2,694.54,48617866
98,2005-10-07,"Good Night, and Good Luck",7000000,31501218,56586901,2005,10,708.38,49586901
99,2005-09-30,Capote,7000000,28750530,49924079,2005,9,613.2,42924079
1,2006-08-04,The Descent,7000000,26024456,57051053,2006,8,715.02,50051053
4,2017-04-07,Gifted,7000000,24801212,36964656,2017,4,428.07,29964656
6,2001-04-11,Kingdom Come,7000000,23247539,23393939,2001,4,234.2,16393939
10,2000-05-05,Michael Jordan to the MAX,7000000,18642318,18642318,2000,5,166.32,11642318
11,2015-06-19,Dope,7000000,17506470,18190831,2015,6,159.87,11190831
12,2005-07-22,The Devil's Rejects,7000000,17044981,20940428,2005,7,199.15,13940428
13,2019-05-24,BrightBurn,7000000,16794432,27989498,2019,5,299.85,20989498
14,2014-01-17,Devil's Due,7000000,15821461,36146087,2014,1,416.37,29146087
16,2014-11-14,Beyond the Lights,7000000,14618727,14618727,2014,11,108.84,7618727
19,2003-04-11,"House of 1,000 Corpses",7000000,12634962,17005466,2003,4,142.94,10005466
21,2003-10-10,House of the Dead,7000000,10199354,13860078,2003,10,98.0,6860078
22,2009-10-02,A Serious Man,7000000,9228788,30360570,2009,10,333.72,23360570
23,2010-07-30,Get Low,7000000,9176933,10828305,2010,7,54.69,3828305
24,2009-12-11,A Single Man,7000000,9176000,28142379,2009,12,302.03,21142379
27,2010-06-18,Cyrus,7000000,7468936,10062896,2010,6,43.76,3062896
29,2005-02-11,Bride & Prejudice,7000000,6601079,25269040,2005,2,260.99,18269040
30,2002-11-29,Rabbit-Proof Fence,7000000,6199600,16866928,2002,11,140.96,9866928
31,2007-07-27,Who's Your Caddy?,7000000,5694308,5694308,2007,7,-18.65,-1305692
34,2001-12-14,The Other Side of Heaven,7000000,4720371,4720371,2001,12,-32.57,-2279629
37,2004-11-12,Veer-Zaara,7000000,2938532,7017859,2004,11,0.26,17859
38,2008-05-02,Redbelt,7000000,2344847,2667084,2008,5,-61.9,-4332916
40,2002-10-18,Auto Focus,7000000,2062066,2703821,2002,10,-61.37,-4296179
41,2011-10-21,The Mighty Macs,7000000,1891936,1891936,2011,10,-72.97,-5108064
42,2010-12-22,Somewhere,7000000,1785645,17023121,2010,12,143.19,10023121
43,2012-01-13,We Need to Talk About Kevin,7000000,1738692,10765283,2012,1,53.79,3765283
44,2007-02-02,Factory Girl,7000000,1661464,1661464,2007,2,-76.26,-5338536
45,2013-11-15,The Christmas Candle,7000000,1632000,1933829,2013,11,-72.37,-5066171
46,2009-09-25,I Hope They Serve Beer in Hell,7000000,1429299,1429453,2009,9,-79.58,-5570547
48,2010-05-07,Mother and Child,7000000,1110509,6537179,2010,5,-6.61,-462821
51,2015-10-02,Freeheld,7000000,546201,1732228,2015,10,-75.25,-5267772
52,2014-04-02,Dom Hemingway,7000000,523511,1857458,2014,4,-73.46,-5142542
53,2010-07-30,The Extra Man,7000000,453377,492108,2010,7,-92.97,-6507892
54,2011-05-13,Hesher,7000000,382946,382946,2011,5,-94.53,-6617054
56,2003-02-14,Gerry,7000000,254683,719699,2003,2,-89.72,-6280301
57,2006-05-12,Wah-Wah,7000000,234750,463039,2006,5,-93.39,-6536961
58,2003-06-13,The Heart of Me,7000000,196067,196067,2003,6,-97.2,-6803933
59,2010-03-26,Ca$h,7000000,46488,46488,2010,3,-99.34,-6953512
60,2015-01-30,Trudno byt bogom,7000000,31443,41038,2015,1,-99.41,-6958962
61,2000-01-21,The Boondock Saints,7000000,30471,411874,2000,1,-94.12,-6588126
62,2014-01-28,Snezhnaya koroleva,7000000,0,15193977,2014,1,117.06,8193977
63,2016-12-06,Oddball,7000000,0,10237229,2016,12,46.25,3237229
64,2015-08-18,Z Storm,7000000,0,2053330,2015,8,-70.67,-4946670
65,2015-12-31,Geroy,7000000,0,1545121,2015,12,-77.93,-5454879
66,2013-07-23,Twixt,7000000,0,1268346,2013,7,-81.88,-5731654
67,2015-11-20,Criminal Activities,7000000,0,386744,2015,11,-94.48,-6613256
73,2012-09-21,House at the End of the Street,6900000,31611916,44103982,2012,9,539.19,37203982
75,2017-01-31,Two Lovers and a Bear,6840000,0,22273,2017,1,-99.67,-6817727
76,2010-09-17,Incendies,6800000,6857096,16038343,2010,9,135.86,9238343
77,2000-08-11,AimÃ©e & Jaguar,6800000,927107,927107,2000,8,-86.37,-5872893
78,2005-08-05,The Chumscrubber,6800000,49526,49526,2005,8,-99.27,-6750474
79,2004-04-09,Shade,6800000,25032,9533964,2004,4,40.21,2733964
80,2010-09-10,Bran Nue Dae,6750000,113568,6812530,2010,9,0.93,62530
81,2004-09-03,"Remember Me, My Love",6700000,223878,223878,2004,9,-96.66,-6476122
82,2010-05-21,Perrierâs Bounty,6600000,828,828,2010,5,-99.99,-6599172
83,2008-09-19,Tropa de Elite,6537890,8744,14319195,2008,9,119.02,7781305
84,2014-10-03,Annabelle,6500000,84273813,256862920,2014,10,3851.74,250362920
85,2008-02-01,Hannah Montana/Miley Cyrus: Best of Both Worlds Concert Tour,6500000,65281781,70712099,2008,2,987.88,64212099
92,2006-04-07,Friends with Money,6500000,13368437,18110152,2006,4,178.62,11610152
95,2017-10-20,Same Kind of Different as Me,6500000,6423605,6423605,2017,10,-1.18,-76395
96,2003-03-07,Nowhere in Africa,6500000,6173485,6173485,2003,3,-5.02,-326515
97,2011-12-02,Shame,6500000,4002293,20412841,2011,12,214.04,13912841
98,2005-05-13,Layer Cake,6500000,2339957,11745931,2005,5,80.71,5245931
99,2013-05-31,The East,6500000,2274649,3027956,2013,5,-53.42,-3472044
100,2005-10-21,The Work and the Glory: American Zion,6500000,2025032,2025032,2005,10,-68.85,-4474968
1,2009-11-13,The Messenger,6500000,1109660,1744952,2009,11,-73.15,-4755048
2,2004-07-23,A Home at the End of the World,6500000,1029017,1033810,2004,7,-84.1,-5466190
3,2001-08-17,Aberdeen,6500000,64148,64148,2001,8,-99.01,-6435852
4,2011-12-31,Tracker,6500000,0,3149,2011,12,-99.95,-6496851
6,2004-02-27,"Good Bye, Lenin!",6400000,4063859,79384539,2004,2,1140.38,72984539
7,2007-10-10,Control,6400000,871577,8902141,2007,10,39.1,2502141
8,2009-10-09,The Damned United,6400000,449865,4199874,2009,10,-34.38,-2200126
9,2008-02-22,Die FÃ¤lscher,6250000,5488570,20199663,2008,2,223.19,13949663
11,2009-02-13,Gomorra,6200000,1579146,37339594,2009,2,502.25,31139594
15,2004-06-23,Fahrenheit 9/11,6000000,119114517,221148959,2004,6,3585.82,215148959
19,2018-05-11,Breaking In,6000000,46840590,51411620,2018,5,756.86,45411620
23,2001-03-23,The Brothers,6000000,27457409,27958191,2001,3,365.97,21958191
24,2008-12-17,The Wrestler,6000000,26238243,46634275,2008,12,677.24,40634275
30,2002-04-05,National Lampoonâs Van Wilder,6000000,21305259,39241323,2002,4,554.02,33241323
32,2000-09-27,Best in Show,6000000,18621249,20695413,2000,9,244.92,14695413
33,2019-03-29,Unplanned,6000000,18107621,18107621,2019,3,201.79,12107621
34,2006-09-27,The Last King of Scotland,6000000,17606684,49155371,2006,9,719.26,43155371
35,2003-04-16,A Mighty Wind,6000000,17583468,18504539,2003,4,208.41,12504539
36,2019-02-08,The Prodigy,6000000,14856291,19789712,2019,2,229.83,13789712
37,2018-11-30,The Possession of Hannah Grace,6000000,14836174,42785387,2018,11,613.09,36785387
39,2007-08-08,Daddy Day Camp,6000000,13235267,18209872,2007,8,203.5,12209872
46,2012-09-07,The Words,6000000,11494838,16369708,2012,9,172.83,10369708
47,2016-01-15,The Lady in the Van,6000000,10021175,42320503,2016,1,605.34,36320503
48,2012-04-27,Bernie,6000000,9204489,10106975,2012,4,68.45,4106975
49,2000-12-15,Pollock,6000000,8596914,10557291,2000,12,75.95,4557291
50,2008-02-15,Dolphins and Whales Tribes of the Ocean 3D,6000000,7714996,17252287,2008,2,187.54,11252287
52,2010-03-19,City Island,6000000,6671283,8173486,2010,3,36.22,2173486
53,2012-03-16,Casa de mi Padre,6000000,5909483,8446952,2012,3,40.78,2446952
54,2011-07-29,The Guard,6000000,5359774,21197454,2011,7,253.29,15197454
55,2000-04-21,The Virgin Suicides,6000000,4859475,10619770,2000,4,77.0,4619770
56,2008-08-29,College,6000000,4694491,6176114,2008,8,2.94,176114
57,2006-09-22,La science des rÃªves,6000000,4670644,15137932,2006,9,152.3,9137932
59,2009-03-13,Miss March,6000000,4543320,4713059,2009,3,-21.45,-1286941
61,2014-07-18,Wish I Was Here,6000000,3591299,6591365,2014,7,9.86,591365
62,2006-12-21,Venus,6000000,3347411,7818479,2006,12,30.31,1818479
63,2014-03-14,Veronica Mars,6000000,3322127,3485383,2014,3,-41.91,-2514617
65,2001-07-20,Hedwig and the Angry Inch,6000000,3067312,3740030,2001,7,-37.67,-2259970
66,2003-10-31,Shattered Glass,6000000,2207975,3456602,2003,10,-42.39,-2543398
67,2008-07-03,The Wackness,6000000,2077046,3330012,2008,7,-44.5,-2669988
68,2001-11-16,Novocaine,6000000,2025238,2522928,2001,11,-57.95,-3477072
69,2009-02-06,Polytechnique,6000000,1418304,1418304,2009,2,-76.36,-4581696
70,2011-07-15,Snow Flower and the Secret Fan,6000000,1348205,11348205,2011,7,89.14,5348205
71,2018-09-14,Mandy,6000000,1214525,1427656,2018,9,-76.21,-4572344
72,2001-12-07,The Business of Strangers,6000000,1030920,1290920,2001,12,-78.48,-4709080
73,2011-04-29,JÃ»san-nin no shikaku,6000000,802778,18727440,2011,4,212.12,12727440
76,2011-03-25,The 5th Quarter,6000000,408159,408159,2011,3,-93.2,-5591841
78,2002-12-20,Morvern Callar,6000000,267194,267194,2002,12,-95.55,-5732806
79,2003-10-10,The Flower of Evil,6000000,181798,181798,2003,10,-96.97,-5818202
80,2011-03-04,Akmareul Boatda,6000000,129210,13168809,2011,3,119.48,7168809
81,2006-11-10,Come Early Morning,6000000,119452,119452,2006,11,-98.01,-5880548
82,2010-04-02,The Greatest,6000000,115862,117796,2010,4,-98.04,-5882204
83,2012-12-07,Deadfall,6000000,66351,1673635,2012,12,-72.11,-4326365
84,2009-05-08,Julia,6000000,65108,1365108,2009,5,-77.25,-4634892
85,2002-04-05,Lucky Break,6000000,54606,4316497,2002,4,-28.06,-1683503
86,2008-09-05,"Surfer, Dude",6000000,36497,36497,2008,9,-99.39,-5963503
87,2015-01-23,Song One,6000000,32251,437089,2015,1,-92.72,-5562911
88,2007-10-03,Lake of Fire,6000000,25317,26007,2007,10,-99.57,-5973993
89,2010-04-02,Don McKay,6000000,13722,13722,2010,4,-99.77,-5986278
98,2003-03-21,L\'auberge espagnole,5900000,3895664,3895664,2003,3,-33.97,-2004336
1,2011-03-18,Winter in Wartime,5800000,542860,9662214,2011,3,66.59,3862214
2,2003-10-03,Foolproof,5800000,230312,421021,2003,10,-92.74,-5378979
3,2012-10-05,Trade of Innocents,5800000,15091,15091,2012,10,-99.74,-5784909
4,2006-09-08,Tom yum goong,5700000,12044087,43044087,2006,9,655.16,37344087
6,2012-09-07,The Inbetweeners,5700000,35955,86051320,2012,9,1409.67,80351320
7,2010-07-16,Valhalla Rising,5700000,30638,731613,2010,7,-87.16,-4968387
8,2003-03-12,Bend it Like Beckham,5600000,32543449,74566042,2003,3,1231.54,68966042
9,2006-09-01,Crossover,5600000,7009668,7009668,2006,9,25.17,1409668
10,2002-06-21,Sunshine State,5600000,3064356,3281898,2002,6,-41.39,-2318102
11,2010-07-16,Standing Ovation,5600000,531806,531806,2010,7,-90.5,-5068194
12,2012-12-07,Khiladi 786,5600000,385422,14683763,2012,12,162.21,9083763
13,2010-07-09,[Rec] 2,5600000,27766,18527766,2010,7,230.85,12927766
16,2005-02-25,Diary of a Mad Black Woman,5500000,50406346,50458356,2005,2,817.42,44958356
18,2013-09-27,Don Jon,5500000,24477704,41268579,2013,9,650.34,35768579
20,2018-09-28,Hell Fest,5500000,11107431,18119231,2018,9,229.44,12619231
21,2003-06-06,Mambo Italiano,5500000,9282750,12399772,2003,6,125.45,6899772
22,2001-07-20,Ghost World,5500000,6217849,8761608,2001,7,59.3,3261608
23,2001-12-14,Iris,5500000,5580479,5580479,2001,12,1.46,80479
25,2004-11-26,Les Choristes,5500000,3629758,83529758,2004,11,1418.72,78029758
26,2003-10-03,Wonderland,5500000,1060512,1060512,2003,10,-80.72,-4439488
27,2005-07-01,De battre mon coeur s'est arrÃªtÃ©,5500000,1023424,8589831,2005,7,56.18,3089831
28,2011-04-01,Haevnen,5500000,1008098,15867314,2011,4,188.5,10367314
29,2011-10-21,Le Havre,5500000,611709,13480196,2011,10,145.09,7980196
30,2002-05-17,Harvard Man,5500000,56653,56653,2002,5,-98.97,-5443347
31,2011-07-15,Salvation Boulevard,5500000,28468,28468,2011,7,-99.48,-5471532
32,2015-01-23,R100,5500000,24956,24956,2015,1,-99.55,-5475044
33,2015-05-05,Miss Julie,5500000,0,863895,2015,5,-84.29,-4636105
35,2003-03-07,Irreversible,5400000,792200,8133256,2003,3,50.62,2733256
36,2013-02-26,Tao Jie,5400000,0,4728896,2013,2,-12.43,-671104
37,2006-01-27,Rang De Basanti,5300000,2197694,29197694,2006,1,450.9,23897694
38,2013-07-19,Grabbers,5300000,0,440821,2013,7,-91.68,-4859179
39,2013-10-11,La Vie d'AdÃ¨le â Chapitres 1 & 2,5250000,2450504,22914479,2013,10,336.47,17664479
40,2012-04-27,Hodejegerne,5250000,1200010,20188740,2012,4,284.55,14938740
41,2007-08-03,The Ten,5250000,769726,786677,2007,8,-85.02,-4463323
42,2000-10-27,A Room for Romeo Brass,5250000,20097,20097,2000,10,-99.62,-5229903
43,2017-02-24,The Girl with all the Gifts,5250000,0,4801837,2017,2,-8.54,-448163
45,2005-08-05,Saint Ralph,5200000,795126,1695126,2005,8,-67.4,-3504874
46,2011-04-22,Dum Maaro Dum,5200000,564489,11633427,2011,4,123.72,6433427
48,2002-04-19,My Big Fat Greek Wedding,5000000,241438208,374890034,2002,4,7397.8,369890034
49,2017-02-24,Get Out,5000000,176040665,255367951,2017,2,5007.36,250367951
50,2017-01-20,Split,5000000,138141585,278964806,2017,1,5479.3,273964806
51,2011-10-21,Paranormal Activity 3,5000000,104028807,207039844,2011,10,4040.8,202039844
52,2005-10-28,Saw II,5000000,87025093,152925093,2005,10,2958.5,147925093
53,2013-09-13,Insidious Chapter 2,5000000,83586447,161921515,2013,9,3138.43,156921515
54,2016-03-11,10 Cloverfield Lane,5000000,72082999,108286422,2016,3,2065.73,103286422
55,2016-07-22,Lights Out,5000000,67268835,148806510,2016,7,2876.13,143806510
56,2015-09-11,The Visit,5000000,65206105,98677816,2015,9,1873.56,93677816
57,2002-10-25,Jackass: The Movie,5000000,64282312,79282312,2002,10,1485.65,74282312
58,2017-10-13,Happy Death Day,5000000,55683845,125010260,2017,10,2400.21,120010260
59,2012-10-19,Paranormal Activity 4,5000000,53900335,142817992,2012,10,2756.36,137817992
60,2014-10-24,Ouija,5000000,50856010,103300632,2014,10,1966.01,98300632
62,2013-08-30,No se Aceptan Devoluciones,5000000,44467206,100486616,2013,8,1909.73,95486616
63,2015-08-07,The Gift,5000000,43787265,58978477,2015,8,1079.57,53978477
64,2017-06-23,The Big Sick,5000000,42872467,53972860,2017,6,979.46,48972860
66,2019-05-31,MA,5000000,36049540,44300625,2019,5,786.01,39300625
69,2003-12-24,Monster,5000000,34469210,64240813,2003,12,1184.82,59240813
70,2014-01-03,Paranormal Activity: The Marked Ones,5000000,32462372,90904854,2014,1,1718.1,85904854
72,2014-04-11,Oculus,5000000,27695246,44115496,2014,4,782.31,39115496
73,2013-11-01,Dallas Buyers Club,5000000,27298285,60611845,2013,11,1112.24,55611845
74,2015-08-26,No Escape,5000000,27288872,42844516,2015,8,756.89,37844516
76,2015-02-27,The Lazarus Effect,5000000,25801570,38359310,2015,2,667.19,33359310
77,2001-03-16,Memento,5000000,25544867,39723096,2001,3,694.46,34723096
78,2011-08-26,Our Idiot Brother,5000000,24814830,25861249,2011,8,417.22,20861249
79,2018-03-09,The Strangers: Prey at Night,5000000,24431472,29960051,2018,3,499.2,24960051
80,2006-07-21,Clerks II,5000000,24148068,27342246,2006,7,446.84,22342246
82,2000-10-13,Billy Elliot,5000000,21995263,109253745,2000,10,2085.07,104253745
83,2013-07-05,The Way Way Back,5000000,21502690,26853810,2013,7,437.08,21853810
84,2014-08-29,"As Above, So Below",5000000,21222315,41824066,2014,8,736.48,36824066
85,2016-04-01,Godâs Not Dead 2,5000000,20773069,23551286,2016,4,371.03,18551286
90,2016-02-19,Race,5000000,19115191,23745772,2016,2,374.92,18745772
92,2015-01-16,Still Alice,5000000,18656400,41699612,2015,1,733.99,36699612
94,2011-09-02,Apollo 18,5000000,17686929,26517819,2011,9,430.36,21517819
95,2018-03-23,"Paul, Apostle of Christ",5000000,17547999,25529498,2018,3,410.59,20529498
96,2014-10-10,Addicted,5000000,17390770,17499242,2014,10,249.98,12499242
97,2001-08-31,O (Othello),5000000,16017403,16017403,2001,8,220.35,11017403
3,2013-03-15,Spring Breakers,5000000,14124286,31149251,2013,3,522.99,26149251
4,2017-06-09,It Comes at Night,5000000,13985117,19720203,2017,6,294.4,14720203
5,2002-03-15,Y Tu MamÃ¡ TambiÃ©n,5000000,13649881,33649881,2002,3,573.0,28649881
6,2004-09-24,Shaun of the Dead,5000000,13542874,30332385,2004,9,506.65,25332385
7,2008-10-31,The Haunting of Molly Hartley,5000000,13442412,15318257,2008,10,206.37,10318257
8,2016-07-15,Hillaryâs America: The Secret History of the Democratic Party,5000000,13099931,13099931,2016,7,162.0,8099931
12,2017-03-03,Before I Fall,5000000,12241072,18945682,2017,3,278.91,13945682
14,2009-03-13,Sunshine Cleaning,5000000,12062558,17329337,2009,3,246.59,12329337
15,2016-01-29,Fifty Shades of Black,5000000,11686940,22113075,2016,1,342.26,17113075
19,2009-01-09,Not Easily Broken,5000000,10572742,10732909,2009,1,114.66,5732909
20,2014-05-09,Momsâ Night Out,5000000,10429707,10537341,2014,5,110.75,5537341
21,2017-03-17,The Belko Experiment,5000000,10166820,11792942,2017,3,135.86,6792942
22,2016-03-11,The Perfect Match,5000000,9669521,10182050,2016,3,103.64,5182050
23,2000-10-06,Digimon: The Movie,5000000,9628751,16628751,2000,10,232.58,11628751
24,2004-05-28,Saved!,5000000,8886160,10206551,2004,5,104.13,5206551
25,2003-05-09,Les invasions barbares,5000000,8460000,25913869,2003,5,418.28,20913869
28,2001-04-27,The Forsaken,5000000,6755271,6755271,2001,4,35.11,1755271
29,2018-09-21,Fahrenheit 11/9,5000000,6352306,6653715,2018,9,33.07,1653715
31,2010-05-28,Sea Rex 3D: Journey to a Prehistoric World,5000000,6096582,16515203,2010,5,230.3,11515203
32,2006-01-06,Grandmaâs Boy,5000000,6090172,6590172,2006,1,31.8,1590172
35,2001-07-13,Made,5000000,5308707,5476060,2001,7,9.52,476060
36,2004-11-19,La mala educaciÃ³n,5000000,5211842,40311842,2004,11,706.24,35311842
37,2009-06-12,Moon,5000000,5010163,10676073,2009,6,113.52,5676073
38,2015-09-11,90 Minutes in Heaven,5000000,4816142,4816142,2015,9,-3.68,-183858
39,2016-12-02,Incarnate,5000000,4799774,9371036,2016,12,87.42,4371036
40,2006-05-12,Keeping Up with the Steins,5000000,4339241,4414753,2006,5,-11.7,-585247
42,2008-08-06,Bottle Shock,5000000,4078607,4815890,2008,8,-3.68,-184110
43,2011-02-25,Des Hommes et Des Dieux,5000000,3954651,46263525,2011,2,825.27,41263525
45,2017-03-03,Table 19,5000000,3614896,4620399,2017,3,-7.59,-379601
46,2016-04-15,Green Room,5000000,3220371,3807503,2016,4,-23.85,-1192497
47,2018-03-09,Thoroughbreds,5000000,3072605,3187302,2018,3,-36.25,-1812698
49,2016-03-04,The Other Side of the Door,5000000,3000342,12905107,2016,3,158.1,7905107
50,2011-05-13,Everything Must Go,5000000,2712131,2821010,2011,5,-43.58,-2178990
51,2014-10-10,Kill the Messenger,5000000,2450846,6656705,2014,10,33.13,1656705
52,2010-12-17,Rabbit Hole,5000000,2229058,6205034,2010,12,24.1,1205034
53,2015-10-23,Jem and the Holograms,5000000,2184640,2368937,2015,10,-52.62,-2631063
54,2016-12-28,Paterson,5000000,2141423,10727536,2016,12,114.55,5727536
57,2004-10-22,The Machinist,5000000,1082044,8655397,2004,10,73.11,3655397
59,2008-07-25,American Teen,5000000,942441,989319,2008,7,-80.21,-4010681
60,2014-09-12,Atlas Shrugged: Who Is John Galt?,5000000,851690,851690,2014,9,-82.97,-4148310
61,2003-08-29,Party Monster,5000000,742898,894030,2003,8,-82.12,-4105970
62,2006-07-14,The Oh in Ohio,5000000,418689,648183,2006,7,-87.04,-4351817
64,2013-08-16,Ain't Them Bodies Saints,5000000,391611,1075009,2013,8,-78.5,-3924991
66,2014-09-26,Jimi: All is By My Side,5000000,340911,927074,2014,9,-81.46,-4072926
67,2007-08-03,"Gandhi, My Father",5000000,240425,2015004,2007,8,-59.7,-2984996
68,2008-04-25,Standard Operating Procedure,5000000,228830,332120,2008,4,-93.36,-4667880
69,2011-09-30,Tucker & Dale vs. Evil,5000000,223838,5476793,2011,9,9.54,476793
71,2015-08-07,Cop Car,5000000,134552,143658,2015,8,-97.13,-4856342
72,2010-09-10,"Lovely, Still",5000000,127564,282687,2010,9,-94.35,-4717313
73,2003-06-13,Tycoon,5000000,121016,121016,2003,6,-97.58,-4878984
75,2004-02-27,Decoys,5000000,84733,96760,2004,2,-98.06,-4903240
76,2008-05-30,Stuck,5000000,67505,67505,2008,5,-98.65,-4932495
77,2007-11-16,Redacted,5000000,65388,861325,2007,11,-82.77,-4138675
78,2014-10-17,Rudderless,5000000,56001,567219,2014,10,-88.66,-4432781
79,2005-01-28,Fascination,5000000,16670,83356,2005,1,-98.33,-4916644
80,2009-08-14,Grace,5000000,8297,8297,2009,8,-99.83,-4991703
81,2015-05-15,Area 51,5000000,7556,7556,2015,5,-99.85,-4992444
82,2012-10-26,Mientras duermes,5000000,0,9109597,2012,10,82.19,4109597
83,2009-07-07,Flying By,5000000,0,4568257,2009,7,-8.63,-431743
84,2008-12-31,The Cottage,5000000,0,1504960,2008,12,-69.9,-3495040
85,2014-12-05,Dying of the Light,5000000,0,74639,2014,12,-98.51,-4925361
86,2016-09-02,Yoga Hosers,5000000,0,22958,2016,9,-99.54,-4977042
1,2015-01-23,Mommy,4900000,3498695,17536004,2015,1,257.88,12636004
2,2008-08-29,Obsluhoval jsem anglickÃ©ho krÃ¡le,4900000,617228,7174984,2008,8,46.43,2274984
3,2010-08-20,Soul Kitchen,4900000,276901,23347461,2010,8,376.48,18447461
4,2012-08-17,The Awakening,4900000,95933,6924321,2012,8,41.31,2024321
5,2008-01-18,All Hat,4900000,15198,15198,2008,1,-99.69,-4884802
7,2006-01-06,Hostel,4800000,47326473,82241110,2006,1,1613.36,77441110
8,2013-07-19,Only God Forgives,4800000,775849,4494560,2013,7,-6.36,-305440
9,2011-09-30,Take Shelter,4750000,1728953,4972016,2011,9,4.67,222016
10,2006-01-27,Tristram Shandy: A Cock and Bull Story,4750000,1253413,3061763,2006,1,-35.54,-1688237
13,2006-10-13,Driving Lessons,4700000,239962,239962,2006,10,-94.89,-4460038
17,2004-07-16,Camping Sauvage,4600000,3479302,3479302,2004,7,-24.36,-1120698
18,2012-09-14,Barfi,4600000,2804874,36751984,2012,9,698.96,32151984
19,2005-03-04,Dear Frankie,4600000,1340891,3099369,2005,3,-32.62,-1500631
20,2004-12-29,The Assassination of Richard Nixon,4600000,708776,4880143,2004,12,6.09,280143
21,2011-06-24,Le nom des gens,4600000,514237,9261711,2011,6,101.34,4661711
22,2008-05-28,Savage Grace,4600000,434417,968805,2008,5,-78.94,-3631195
23,2007-10-19,Out of the Blue,4600000,728,731767,2007,10,-84.09,-3868233
29,2002-12-19,25th Hour,4500000,13084595,25344490,2002,12,463.21,20844490
32,2016-03-25,The Lobster,4500000,9196278,18019834,2016,3,300.44,13519834
34,2000-10-06,Requiem for a Dream,4500000,3635482,7389233,2000,10,64.21,2889233
36,2008-10-24,LÃ¥t den rÃ¤tte komma in,4500000,2122085,12247682,2008,10,172.17,7747682
39,2001-10-26,Donnie Darko,4500000,1480006,7510877,2001,10,66.91,3010877
40,2011-09-02,Salvando al Soldado Perez,4500000,1400726,9330465,2011,9,107.34,4830465
42,2011-08-19,Nannerl la soeur de Mozart,4500000,707885,2404639,2011,8,-46.56,-2095361
43,2003-03-14,Spun,4500000,410241,1022649,2003,3,-77.27,-3477351
44,2010-07-23,Life During Wartime,4500000,281447,281447,2010,7,-93.75,-4218553
45,2006-05-04,Chinjeolhan geumjassi,4500000,211667,23471871,2006,5,421.6,18971871
46,2011-10-07,Blackthorn,4500000,200558,1217307,2011,10,-72.95,-3282693
47,2015-05-08,Maggie,4500000,187112,1027760,2015,5,-77.16,-3472240
48,2003-04-18,Lilja 4-ever,4500000,181655,4556982,2003,4,1.27,56982
49,2010-04-09,After.Life,4500000,108596,2481925,2010,4,-44.85,-2018075
50,2002-02-22,Mean Machine,4500000,92723,92723,2002,2,-97.94,-4407277
51,2007-08-31,Fong juk,4500000,51957,51957,2007,8,-98.85,-4448043
52,2010-07-23,Spoken Word,4500000,32961,32961,2010,7,-99.27,-4467039
53,2013-03-01,The Sweeney,4500000,26345,8000366,2013,3,77.79,3500366
54,2014-09-04,Falcon Rising,4500000,11774,11774,2014,9,-99.74,-4488226
62,2016-12-31,Airlift (2016),4400000,0,9969237,2016,12,126.57,5569237
64,2014-06-06,Anna,4357373,0,1200000,2014,6,-72.46,-3157373
65,2003-06-06,Whale Rider,4300000,20779666,39374600,2003,6,815.69,35074600
66,2001-06-13,Sexy Beast,4300000,6946056,10158355,2001,6,136.24,5858355
67,2009-12-04,Paa,4300000,199228,9791282,2009,12,127.7,5491282
68,2012-07-11,Snabba Cash,4300000,188870,10212403,2012,7,137.5,5912403
70,2006-02-17,Nochnoy dozor,4200000,1502188,33913542,2006,2,707.47,29713542
71,2010-08-13,Animal Kingdom,4200000,1044039,8078683,2010,8,92.35,3878683
72,2010-05-28,George A. Romero's Survival of the Dead,4200000,101740,101740,2010,5,-97.58,-4098260
73,2011-10-21,Cargo,4200000,0,313230,2011,10,-92.54,-3886770
79,2003-09-12,Lost in Translation,4000000,44585453,117085297,2003,9,2827.13,113085297
81,2015-01-23,The Boy Next Door,4000000,36006065,53401938,2015,1,1235.05,49401938
84,2001-12-26,Monster's Ball,4000000,31273922,43766463,2001,12,994.16,39766463
85,2014-07-11,Boyhood,4000000,25379975,57273049,2014,7,1331.83,53273049
87,2010-07-09,The Kids Are All Right,4000000,20811365,36275469,2010,7,806.89,32275469
89,2014-04-18,A Haunted House 2,4000000,17329487,21206861,2014,4,430.17,17206861
90,2013-03-01,The Last Exorcism Part II,4000000,15179303,25448707,2013,3,536.22,21448707
95,2000-08-04,Saving Grace,4000000,12178602,27786849,2000,8,594.67,23786849
97,2004-02-06,What the #$'! Do We Know,4000000,10941801,10941801,2004,2,173.55,6941801
98,2016-05-13,The Darkness,4000000,10753574,10898293,2016,5,172.46,6898293
99,2006-07-28,Scoop,4000000,10525717,40103262,2006,7,902.58,36103262
100,2001-11-14,The Wash,4000000,10097096,10097096,2001,11,152.43,6097096
1,2000-03-01,3 Strikes,4000000,9821335,9821335,2000,3,145.53,5821335
2,2008-04-11,The Visitor,4000000,9427026,19174817,2008,4,379.37,15174817
3,2003-11-26,The Cooler,4000000,8291572,11131455,2003,11,178.29,7131455
5,2006-08-04,The Night Listener,4000000,7836393,10770993,2006,8,169.27,6770993
7,2007-12-28,El orfanato,4000000,7159147,79250193,2007,12,1881.25,75250193
8,2007-05-25,Bug,4000000,7006708,8302995,2007,5,107.57,4302995
9,2002-10-11,The Rules of Attraction,4000000,6525762,11799060,2002,10,194.98,7799060
11,2006-11-17,Let's Go to Prison,4000000,4630045,4630045,2006,11,15.75,630045
13,2002-09-20,Secretary,4000000,4046737,9413956,2002,9,135.35,5413956
14,2003-04-25,The Real Cancun,4000000,3816594,3816594,2003,4,-4.59,-183406
18,2012-08-24,Samsara,4000000,2672413,5966671,2012,8,49.17,1966671
19,2007-06-22,You Kill Me,4000000,2426851,3858964,2007,6,-3.53,-141036
20,2011-06-17,The Art of Getting By,4000000,1430241,1989035,2011,6,-50.27,-2010965
21,2005-09-16,Thumbsucker,4000000,1328679,1919197,2005,9,-52.02,-2080803
22,2011-09-23,Red State,4000000,1065429,1983596,2011,9,-50.41,-2016404
23,2005-09-30,MirrorMask,4000000,864959,973613,2005,9,-75.66,-3026387
25,2012-10-17,Holy Motors,4000000,641054,4230426,2012,10,5.76,230426
26,2014-06-13,The Signal,4000000,600896,2665322,2014,6,-33.37,-1334678
27,2003-02-28,Poolhall Junkies,4000000,563711,563711,2003,2,-85.91,-3436289
29,2014-03-07,The Face of Love,4000000,385069,1158877,2014,3,-71.03,-2841123
30,2014-04-11,Joe,4000000,373375,373375,2014,4,-90.67,-3626625
33,2009-05-08,Adoration,4000000,294244,384244,2009,5,-90.39,-3615756
34,2000-08-04,Psycho Beach Party,4000000,267972,267972,2000,8,-93.3,-3732028
35,2019-06-07,Late Night,4000000,246305,246305,2019,6,-93.84,-3753695
36,2000-01-28,The Big Tease,4000000,185577,185577,2000,1,-95.36,-3814423
37,2017-08-25,Polina danser sa vie,4000000,165203,953314,2017,8,-76.17,-3046686
38,2015-04-10,Desert Dancer,4000000,155271,596335,2015,4,-85.09,-3403665
39,2015-01-30,"Guten Tag, Ramon",4000000,154356,4854356,2015,1,21.36,854356
40,2003-07-25,Mondays in the Sun,4000000,146402,146402,2003,7,-96.34,-3853598
41,2015-06-19,Manglehorn,4000000,132270,797439,2015,6,-80.06,-3202561
42,2010-04-02,Tau ming chong,4000000,129078,38899792,2010,4,872.49,34899792
43,2011-04-01,Trust,4000000,120016,120016,2011,4,-97.0,-3879984
44,2000-12-22,An Everlasting Piece,4000000,75078,75078,2000,12,-98.12,-3924922
47,2011-04-22,Stake Land,4000000,33245,679482,2011,4,-83.01,-3320518
48,2015-02-27,Praia do Futuro,4000000,20620,760678,2015,2,-80.98,-3239322
49,2002-12-27,Sonny,4000000,17639,17639,2002,12,-99.56,-3982361
51,2014-04-18,13 Sins,4000000,9134,47552,2014,4,-98.81,-3952448
52,2011-11-18,Another Happy Day,4000000,9120,978527,2011,11,-75.54,-3021473
53,2013-02-22,Inescapable,4000000,4327,4327,2013,2,-99.89,-3995673
54,2017-12-31,Perfectos Desconocidos,4000000,0,31166312,2017,12,679.16,27166312
55,2013-12-31,Geograf globus propil,4000000,0,4454853,2013,12,11.37,454853
56,2012-03-20,A Lonely Place to Die,4000000,0,442550,2012,3,-88.94,-3557450
57,2003-12-31,Nothing,4000000,0,63180,2003,12,-98.42,-3936820
58,2012-06-01,The Loved Ones,4000000,0,12302,2012,6,-99.69,-3987698
72,2011-01-14,Down for Life,3800000,41914,41914,2011,1,-98.9,-3758086
73,2010-04-30,The Good Heart,3800000,20930,340930,2010,4,-91.03,-3459070
75,2018-10-05,Hevi reissu,3800000,10153,10153,2018,10,-99.73,-3789847
78,2006-08-11,Casa de Areia,3750000,539285,1178175,2006,8,-68.58,-2571825
79,2010-11-05,Four Lions,3750000,310007,2436111,2010,11,-35.04,-1313889
80,2010-02-19,Defendor,3750000,44462,44462,2010,2,-98.81,-3705538
83,2006-11-21,The History Boys,3700000,2730296,13447998,2006,11,263.46,9747998
84,2006-11-03,Unknown,3700000,26403,3355048,2006,11,-9.32,-344952
86,2008-10-10,Billy: The Early Years of Billy Graham,3600000,320896,320896,2008,10,-91.09,-3279104
87,2017-12-31,UtÃ¸ya 22. juli,3600000,0,173156,2017,12,-95.19,-3426844
91,2018-04-13,Truth or Dare,3500000,41411015,95127344,2018,4,2617.92,91627344
94,2016-02-19,The Witch,3500000,25138705,40454520,2016,2,1055.84,36954520
95,2018-02-02,Winchester,3500000,25091816,44378040,2018,2,1167.94,40878040
96,2002-12-06,Empire,3500000,17504595,18495444,2002,12,428.44,14995444
97,2013-02-22,Dark Skies,3500000,17418667,27704111,2013,2,691.55,24204111
98,2018-01-19,Forever My Girl,3500000,16376066,16376066,2018,1,367.89,12876066
8,2010-04-16,El secreto de sus ojos,3500000,6391436,40527719,2010,4,1057.93,37027719
11,2018-05-18,First Reformed,3500000,3448256,3874772,2018,5,10.71,374772
12,2001-06-29,Pootie Tang,3500000,3293258,3293258,2001,6,-5.91,-206742
13,2016-12-02,Believe,3500000,890303,890303,2016,12,-74.56,-2609697
14,2000-04-19,La otra conquista,3500000,886410,886410,2000,4,-74.67,-2613590
15,2016-09-30,American Honey,3500000,663247,2611750,2016,9,-25.38,-888250
16,2016-03-18,The Bronze,3500000,615816,615816,2016,3,-82.41,-2884184
17,2011-06-10,Trolljegeren,3500000,253444,5706638,2011,6,63.05,2206638
18,2007-09-14,Ira and Abby,3500000,221096,221096,2007,9,-93.68,-3278904
19,2016-01-08,The Masked Saint,3500000,182695,182695,2016,1,-94.78,-3317305
20,2006-02-17,Winter Passing,3500000,107492,113783,2006,2,-96.75,-3386217
21,2005-03-25,D.E.B.S.,3500000,96793,96793,2005,3,-97.23,-3403207
22,2016-06-03,Time to Choose,3500000,29233,29233,2016,6,-99.16,-3470767
23,2009-06-26,Surveillance,3500000,27349,1396395,2009,6,-60.1,-2103605
25,2011-12-31,The Kick,3500000,0,40622,2011,12,-98.84,-3459378
33,2013-05-17,Jagten,3450000,687185,18309793,2013,5,430.72,14859793
35,2005-06-24,La marche de l'empereur,3400000,77437223,133276359,2005,6,3819.89,129876359
37,2011-10-21,Margin Call,3400000,5353586,20433227,2011,10,500.98,17033227
38,2008-09-26,Choke,3400000,2926565,4124277,2008,9,21.3,724277
39,2004-04-23,L\'incomparable mademoiselle C.,3400000,493905,493905,2004,4,-85.47,-2906095
40,2008-07-11,August,3400000,12636,12636,2008,7,-99.63,-3387364
43,2014-10-10,Whiplash,3300000,13092006,38969037,2014,10,1080.88,35669037
44,2007-10-26,Bella,3300000,8093373,12405473,2007,10,275.92,9105473
45,2003-01-17,Cidade de Deus,3300000,7563397,32059295,2003,1,871.49,28759295
46,2000-05-05,Human Traffic,3300000,104257,5422740,2000,5,64.33,2122740
47,2006-12-29,The Dead Girl,3300000,19875,19875,2006,12,-99.4,-3280125
48,2015-01-20,The Opposite Sex,3300000,0,50206,2015,1,-98.48,-3249794
51,2009-01-30,Entre les murs,3250000,3766810,34114067,2009,1,949.66,30864067
54,2018-07-06,Sorry to Bother You,3200000,17493096,18285560,2018,7,471.42,15085560
56,2004-07-16,Maria Full of Grace,3200000,6529624,14441158,2004,7,351.29,11241158
57,2011-06-03,Beginners,3200000,5790894,14314407,2011,6,347.33,11114407
58,2016-04-22,The Meddler,3200000,4267219,5526942,2016,4,72.72,2326942
59,2009-07-29,Adam,3200000,2283291,2834485,2009,7,-11.42,-365515
60,2006-09-22,Feast,3200000,56131,690872,2006,9,-78.41,-2509128
63,2013-04-12,Antiviral,3100000,0,123407,2013,4,-96.02,-2976593
65,2010-10-20,Paranormal Activity 2,3000000,84752907,177512032,2010,10,5817.07,174512032
66,2015-08-28,War Room,3000000,67790117,73975239,2015,8,2365.84,70975239
67,2013-06-07,The Purge,3000000,64473115,91266581,2013,6,2942.22,88266581
69,2012-10-12,Sinister,3000000,48086903,87727807,2012,10,2824.26,84727807
70,2000-08-18,The Original Kings of Comedy,3000000,38168022,38236338,2000,8,1174.54,35236338
75,2002-10-11,Bowling for Columbine,3000000,21576018,58240487,2002,10,1841.35,55240487
80,2002-08-02,Martin Lawrence Live: RunTelDat,3000000,19184820,19184820,2002,8,539.49,16184820
84,2001-04-06,Pokemon 3: The Movie,3000000,17052128,68452128,2001,4,2181.74,65452128
89,2018-06-01,Upgrade,3000000,11977130,16553285,2018,6,451.78,13553285
90,2006-03-03,Dave Chappelle's Block Party,3000000,11718595,12051924,2006,3,301.73,9051924
93,2009-05-08,Next Day Air,3000000,10027047,10172519,2009,5,239.08,7172519
98,2001-08-08,The Deep End,3000000,8823109,9981635,2001,8,232.72,6981635
99,2013-05-24,Before Midnight,3000000,8110621,23251930,2013,5,675.06,20251930
1,2009-07-31,The Collector,3000000,7712114,10473836,2009,7,249.13,7473836
3,2017-10-27,Let There Be Light,3000000,7233471,7241309,2017,10,141.38,4241309
4,2006-04-07,Phat Girlz,3000000,7061128,7301115,2006,4,143.37,4301115
5,2004-10-01,Woman Thou Art Loosed,3000000,6879730,6879730,2004,10,129.32,3879730
6,2002-10-18,Real Women Have Curves,3000000,5853194,7777790,2002,10,159.26,4777790
8,2006-04-28,Water,3000000,5529144,11322573,2006,4,277.42,8322573
9,2016-07-22,Donât Think Twice,3000000,4417983,4417983,2016,7,47.27,1417983
10,2016-06-24,Swiss Army Man,3000000,4210454,5837111,2016,6,94.57,2837111
11,2000-04-14,East is East,3000000,4170647,30438635,2000,4,914.62,27438635
12,2000-09-01,Whipped,3000000,4142507,4142507,2000,9,38.08,1142507
14,2013-05-17,Frances Ha,3000000,4067398,11262769,2013,5,275.43,8262769
15,2010-04-30,Please Give,3000000,4033574,4570178,2010,4,52.34,1570178
20,2002-05-24,Thirteen Conversations About One Thing,3000000,3287435,3705923,2002,5,23.53,705923
21,2016-04-22,Compadres,3000000,3127773,7445044,2016,4,148.17,4445044
24,2006-02-24,Tsotsi,3000000,2912606,11537539,2006,2,284.58,8537539
25,2010-04-09,Letters to God,3000000,2848587,3237452,2010,4,7.92,237452
27,2003-04-04,DysFunkTional Family,3000000,2255000,2255000,2003,4,-24.83,-745000
28,2014-09-19,Tusk,3000000,1821983,1887554,2014,9,-37.08,-1112446
29,2017-05-12,The Wall,3000000,1803064,4495262,2017,5,49.84,1495262
30,2003-10-24,Elephant,3000000,1266955,10051516,2003,10,235.05,7051516
31,2012-04-06,Damsels in Distress,3000000,1007535,1324299,2012,4,-55.86,-1675701
32,2005-03-25,Oldboy,3000000,707391,6239723,2005,3,107.99,3239723
33,2011-05-06,Hobo with a Shotgun,3000000,703372,834953,2011,5,-72.17,-2165047
34,2015-05-08,The D Train,3000000,669688,772366,2015,5,-74.25,-2227634
35,2012-09-07,Bachelorette,3000000,446770,12577401,2012,9,319.25,9577401
36,2010-01-15,Fish Tank,3000000,374675,5922292,2010,1,97.41,2922292
37,2008-09-05,Everybody Wants to Be Italian,3000000,351416,351416,2008,9,-88.29,-2648584
38,2011-09-09,Creature,3000000,331000,331000,2011,9,-88.97,-2669000
39,2016-12-09,The Bounce Back,3000000,321910,421404,2016,12,-85.95,-2578596
41,2006-10-06,Love's Abiding Joy,3000000,252726,252726,2006,10,-91.58,-2747274
43,2010-10-01,Chain Letter,3000000,205842,1022453,2010,10,-65.92,-1977547
44,2012-03-02,Tim and Eric's Billion Dollar Movie,3000000,201436,223652,2012,3,-92.54,-2776348
45,2007-11-09,Holly,3000000,163069,163069,2007,11,-94.56,-2836931
46,2010-03-26,The Eclipse,3000000,133411,133411,2010,3,-95.55,-2866589
47,2008-03-21,The Grand,3000000,115879,115879,2008,3,-96.14,-2884121
48,2006-03-17,Sommersturm,3000000,95204,95204,2006,3,-96.83,-2904796
49,2014-08-15,Fort McCoy,3000000,78948,78948,2014,8,-97.37,-2921052
51,2000-10-13,Just Looking,3000000,39852,39852,2000,10,-98.67,-2960148
52,2015-09-04,Before We Go,3000000,37151,483938,2015,9,-83.87,-2516062
53,2012-01-13,The Divide,3000000,18000,156362,2012,1,-94.79,-2843638
54,2011-09-09,Tanner Hall,3000000,5073,5073,2011,9,-99.83,-2994927
55,2005-09-30,My Big Fat Independent Movie,3000000,4655,4655,2005,9,-99.84,-2995345
56,2017-10-10,Demonic,3000000,0,4668109,2017,10,55.6,1668109
57,2008-04-15,Ã l\'intÃ©rieur,3000000,0,895932,2008,4,-70.14,-2104068
58,2014-06-27,They Came Together,3000000,0,82780,2014,6,-97.24,-2917220
59,2013-05-21,Open Road,3000000,0,47469,2013,5,-98.42,-2952531
79,2006-03-24,Boynton Beach Club,2900000,3127472,3127472,2006,3,7.84,227472
80,2010-10-01,Freakonomics,2900000,101270,172867,2010,10,-94.04,-2727133
81,2011-08-19,Griff the Invisible,2900000,20778,25935,2011,8,-99.11,-2874065
83,2005-06-10,High Tension,2850000,3681066,6435262,2005,6,125.8,3585262
86,2005-07-22,Hustle & Flow,2800000,22202809,23591783,2005,7,742.56,20791783
88,2006-09-15,Artie Lange's Beer League,2800000,475000,475000,2006,9,-83.04,-2325000
90,2008-02-15,Diary of the Dead,2750000,952620,5394447,2008,2,96.16,2644447
93,2018-10-26,Indivisible,2700000,3511417,3588305,2018,10,32.9,888305
94,2006-09-01,Lage Raho Munna Bhai,2700000,2217561,31517561,2006,9,1067.32,28817561
95,2015-12-31,Sardaar Ji,2700000,0,8200000,2015,12,203.7,5500000
96,2008-12-31,Rejsen til Saturn,2700000,0,5377665,2008,12,99.17,2677665
3,2014-05-02,Ida,2600000,3827060,15298355,2014,5,488.4,12698355
5,2004-07-09,Riding Giants,2600000,2276368,3292333,2004,7,26.63,692333
6,2008-12-12,Los CronocrÃ­menes,2600000,39127,564474,2008,12,-78.29,-2035526
7,2011-12-31,La Cara Oculta,2600000,0,7033931,2011,12,170.54,4433931
8,2007-12-07,Timber Falls,2600000,0,71248,2007,12,-97.26,-2528752
12,2013-01-11,A Haunted House,2500000,40041683,59922558,2013,1,2296.9,57422558
13,2012-07-13,2016: Obamaâs America,2500000,33349941,33349941,2012,7,1234.0,30849941
14,2013-07-03,Kevin Hart: Let Me Explain,2500000,32244051,32327255,2013,7,1193.09,29827255
15,2004-07-28,Garden State,2500000,26782316,36028802,2004,7,1341.15,33528802
19,2008-10-01,Religulous,2500000,13011160,13881317,2008,10,455.25,11381317
22,2013-08-02,The Spectacular Now,2500000,6852971,6916951,2013,8,176.68,4416951
25,2016-06-24,Hunt for the Wilderpeople,2500000,5205471,23845533,2016,6,853.82,21345533
26,2012-08-17,Robot & Frank,2500000,3317468,4934356,2012,8,97.37,2434356
27,2003-10-03,Sur Le Seuil,2500000,2013052,2013052,2003,10,-19.48,-486948
28,2000-06-16,Jesus' Son,2500000,1282084,1687548,2000,6,-32.5,-812452
29,2005-05-27,Saving Face,2500000,1187266,1269705,2005,5,-49.21,-1230295
30,2008-06-20,Brick Lane,2500000,1094998,3838486,2008,6,53.54,1338486
31,2013-03-01,The Lost Medallion: The Adventures of Billy Stone,2500000,549632,549632,2013,3,-78.01,-1950368
32,2003-09-26,My Life Without Me,2500000,432360,12267275,2003,9,390.69,9767275
33,2006-03-31,Marilyn Hotchkiss' Ballroom Dancing and Charm School,2500000,349132,497195,2006,3,-80.11,-2002805
34,2011-04-01,Super,2500000,327716,593933,2011,4,-76.24,-1906067
35,2008-11-14,Fuel,2500000,174255,174255,2008,11,-93.03,-2325745
36,2010-04-09,Valley of the Hearts Delight,2500000,118666,118666,2010,4,-95.25,-2381334
37,2008-10-31,The Other End of the Line,2500000,115504,507446,2008,10,-79.7,-1992554
38,2010-06-18,8: The Mormon Proposition,2500000,100280,100280,2010,6,-95.99,-2399720
39,2009-04-17,Sleep Dealer,2500000,80136,108907,2009,4,-95.64,-2391093
40,2007-08-24,Eye of the Dolphin,2500000,72210,72260,2007,8,-97.11,-2427740
41,2013-08-16,Underdogs,2500000,35017,1392649,2013,8,-44.29,-1107351
42,2000-09-08,Anatomie,2500000,9598,9598,2000,9,-99.62,-2490402
52,2011-05-13,Go For It!,2450000,180237,182358,2011,5,-92.56,-2267642
54,2007-01-05,Thr3e,2400000,1008849,1420418,2007,1,-40.82,-979582
55,2006-09-01,Idiocracy,2400000,444093,500296,2006,9,-79.15,-1899704
56,2009-12-31,NiktÃ©,2400000,0,1333891,2009,12,-44.42,-1066109
58,2007-07-25,This is England,2380000,327919,8739576,2007,7,267.21,6359576
60,2015-03-20,Do You Believe?,2300000,12985600,14304931,2015,3,521.95,12004931
63,2014-09-05,Frontera,2300000,59696,59696,2014,9,-97.4,-2240304
64,2011-08-26,Redemption Road,2300000,29384,29384,2011,8,-98.72,-2270616
73,2007-02-09,The Last Sin Eater,2200000,388390,388390,2007,2,-82.35,-1811610
76,2005-12-31,Chicken Tikka Masala,2160000,0,37865,2005,12,-98.25,-2122135
79,2001-07-13,Bully,2100000,881824,1381824,2001,7,-34.2,-718176
80,2002-05-29,Elling,2100000,313436,313436,2002,5,-85.07,-1786564
81,2016-10-16,Mi America,2100000,3330,3330,2016,10,-99.84,-2096670
82,2009-07-14,[Rec],2100000,0,23266821,2009,7,1007.94,21166821
87,2011-09-30,Courageous,2000000,34522221,35185884,2011,9,1659.29,33185884
94,2015-03-13,It Follows,2000000,14674077,23250755,2015,3,1062.54,21250755
95,2018-07-13,Eighth Grade,2000000,13539710,14341016,2018,7,617.05,12341016
97,2012-03-09,Silent House,2000000,12739737,16610760,2012,3,730.54,14610760
99,2007-02-09,Das Leben der Anderen,2000000,11284657,81197047,2007,2,3959.85,79197047
100,2016-04-08,Hardcore Henry,2000000,9252038,17187434,2016,4,759.37,15187434
6,2003-11-26,Les Triplettes de Belleville,2000000,7301288,17403168,2003,11,770.16,15403168
8,2010-06-11,Winter's Bone,2000000,6531503,16131551,2010,6,706.58,14131551
9,2014-10-10,Meet the Mormons,2000000,6047363,6049171,2014,10,202.46,4049171
10,2003-08-15,American Splendor,2000000,6003587,8685632,2003,8,334.28,6685632
11,2017-10-06,The Florida Project,2000000,5904366,11295324,2017,10,464.77,9295324
12,2017-08-25,All Saints,2000000,5802208,5941994,2017,8,197.1,3941994
13,2004-07-02,Before Sunset,2000000,5792822,11217346,2004,7,460.87,9217346
14,2001-03-30,Amores Perros,2000000,5383834,20883834,2001,3,944.19,18883834
15,2003-08-20,Thirteen,2000000,4601043,9505996,2003,8,375.3,7505996
16,2004-01-23,Touching the Void,2000000,4593598,15396525,2004,1,669.83,13396525
17,2010-10-08,Inside Job,2000000,4311834,7799257,2010,10,289.96,5799257
19,2005-06-17,Me and You and Everyone We Know,2000000,3885134,9615464,2005,6,380.77,7615464
20,2015-08-28,We Are Your Friends,2000000,3591417,10153415,2015,8,407.67,8153415
21,2006-11-10,Harsh Times,2000000,3337931,6225304,2006,11,211.27,4225304
22,2000-03-03,Ghost Dog: The Way of the Samurai,2000000,3330230,10672492,2000,3,433.62,8672492
23,2015-09-18,Captive,2000000,2583301,2791973,2015,9,39.6,791973
24,2002-08-02,Full Frontal,2000000,2512846,3438804,2002,8,71.94,1438804
25,2018-06-08,Hearts Beat Loud,2000000,2386254,2420962,2018,6,21.05,420962
26,2017-01-20,The Resurrection of Gavin Stone,2000000,2303792,2303792,2017,1,15.19,303792
27,2008-12-25,Waltz with Bashir,2000000,2283849,13912289,2008,12,595.61,11912289
28,2006-06-28,Strangers with Candy,2000000,2072645,2077844,2006,6,3.89,77844
31,2006-10-04,Shortbus,2000000,1985292,1985292,2006,10,-0.74,-14708
32,2008-05-02,Son of Rambow: A Home Movie,2000000,1785505,11263263,2008,5,463.16,9263263
33,2003-09-12,"The Book of Mormon Movie, Volume 1: The Journey",2000000,1660865,1660865,2003,9,-16.96,-339135
34,2000-05-12,Hamlet,2000000,1577287,2419669,2000,5,20.98,419669
35,2015-08-07,The Diary of a Teenage Girl,2000000,1477002,2279959,2015,8,14.0,279959
36,2007-07-27,No End In Sight,2000000,1433319,1433319,2007,7,-28.33,-566681
37,2014-04-25,Locke,2000000,1370646,2088390,2014,4,4.42,88390
39,2007-09-07,In the Shadow of the Moon,2000000,1134358,2175587,2007,9,8.78,175587
40,2011-04-08,Meek's Cutoff,2000000,977772,1869928,2011,4,-6.5,-130072
41,2014-11-28,The Babadook,2000000,950792,7482387,2014,11,274.12,5482387
42,2005-02-11,Inside Deep Throat,2000000,691880,691880,2005,2,-65.41,-1308120
43,2001-09-28,Dinner Rush,2000000,638227,1075504,2001,9,-46.22,-924496
44,2010-09-24,The Virginity Hit,2000000,636706,636706,2010,9,-68.16,-1363294
47,2005-04-15,House of D,2000000,388532,466106,2005,4,-76.69,-1533894
48,2008-01-18,Teeth,2000000,347578,2350641,2008,1,17.53,350641
50,2006-09-08,Sherrybaby,2000000,199176,759504,2006,9,-62.02,-1240496
51,2015-02-13,The Last Five Years,2000000,147299,205298,2015,2,-89.74,-1794702
53,2000-05-26,Hum to Mohabbt Karega,2000000,121807,121807,2000,5,-93.91,-1878193
54,2005-04-15,It's All Gone Pete Tong,2000000,120620,2226603,2005,4,11.33,226603
55,2010-01-29,Saint John of Las Vegas,2000000,102645,102645,2010,1,-94.87,-1897355
57,2014-09-19,Pump,2000000,72277,72277,2014,9,-96.39,-1927723
58,2008-10-24,Roadside Romeo,2000000,55202,2046090,2008,10,2.3,46090
59,2001-05-04,Eureka,2000000,49388,76654,2001,5,-96.17,-1923346
60,2015-04-07,Lost River,2000000,45431,2009644,2015,4,0.48,9644
61,2003-07-18,This Thing of Ours,2000000,37227,37227,2003,7,-98.14,-1962773
62,2015-10-09,Knock Knock,2000000,36336,6328516,2015,10,216.43,4328516
63,2017-02-03,Growing up Smith,2000000,35312,35312,2017,2,-98.23,-1964688
64,2009-03-20,Super Capers,2000000,30955,30955,2009,3,-98.45,-1969045
66,2009-11-20,The Missing Person,2000000,17896,17896,2009,11,-99.11,-1982104
67,2012-10-19,The First Time,2000000,17061,17061,2012,10,-99.15,-1982939
68,2006-02-10,London,2000000,12667,12667,2006,2,-99.37,-1987333
69,2010-08-27,Circle,2000000,10024,10024,2010,8,-99.5,-1989976
70,2008-10-31,Eden Lake,2000000,7321,4294373,2008,10,114.72,2294373
71,2010-06-11,Jerusalema,2000000,7294,10679,2010,6,-99.47,-1989321
72,2006-06-23,Say Uncle,2000000,5361,5361,2006,6,-99.73,-1994639
73,2013-09-13,Plush,2000000,3080,28864,2013,9,-98.56,-1971136
74,2012-10-26,The Ghastly Love of Johnny X,2000000,2436,2436,2012,10,-99.88,-1997564
75,2009-12-29,Lesbian Vampire Killers,2000000,0,3620902,2009,12,81.05,1620902
76,2011-09-09,Grave Encounters,2000000,0,2151887,2011,9,7.59,151887
77,2015-10-23,Bone Tomahawk,2000000,0,475846,2015,10,-76.21,-1524154
78,2004-12-10,Freeze Frame,2000000,0,105377,2004,12,-94.73,-1894623
79,2013-04-01,Stitches,2000000,0,63555,2013,4,-96.82,-1936445
80,2015-12-31,"To Be Frank, Sinatra at 100",2000000,0,926,2015,12,-99.95,-1999074
2,2010-09-24,Buried,1987650,1044143,21270290,2010,9,970.12,19282640
5,2008-07-25,Man on Wire,1900000,2962242,5617067,2008,7,195.64,3717067
6,2010-10-08,Nowhere Boy,1900000,1445366,7785229,2010,10,309.75,5885229
7,2003-07-11,Northfork,1900000,1420578,1445140,2003,7,-23.94,-454860
8,2015-04-24,Brotherly Love,1900000,478595,478595,2015,4,-74.81,-1421405
9,2011-06-03,Submarine,1900000,467602,4581937,2011,6,141.15,2681937
10,2010-04-09,The Square,1900000,406216,740932,2010,4,-61.0,-1159068
11,2013-02-08,ABCD (Any Body Can Dance),1900000,222098,10137234,2013,2,433.54,8237234
12,2007-06-29,Chacun sa nuit,1900000,18435,139317,2007,6,-92.67,-1760683
13,2013-07-26,Stranded,1900000,0,285593,2013,7,-84.97,-1614407
14,2015-12-31,Vaalu,1900000,0,12444,2015,12,-99.35,-1887556
15,2010-08-27,The Last Exorcism,1800000,41034350,70165900,2010,8,3798.11,68365900
18,2012-06-27,Beasts of the Southern Wild,1800000,12795746,23265132,2012,6,1192.51,21465132
23,2002-11-15,El crimen de padre Amaro,1800000,5719000,5719000,2002,11,217.72,3919000
24,2001-06-15,Songcatcher,1800000,3050934,3050934,2001,6,69.5,1250934
25,2011-08-23,Higher Ground,1800000,841056,842693,2011,8,-53.18,-957307
26,2011-04-22,POM Wonderful Presents: The Greatest Movie Ever Sold,1800000,638476,783733,2011,4,-56.46,-1016267
27,2005-01-07,Travellers and Magicians,1800000,506793,1322161,2005,1,-26.55,-477839
36,2003-02-07,May,1750000,145540,634803,2003,2,-63.73,-1115197
37,2010-10-08,I Spit on Your Grave,1750000,93051,1278471,2010,10,-26.94,-471529
39,2001-11-23,In the Bedroom,1700000,35930604,42137871,2001,11,2378.7,40437871
40,2008-03-19,La misma luna,1700000,12590147,23271741,2008,3,1268.93,21571741
42,2014-02-28,The Lunchbox,1700000,4231500,12231500,2014,2,619.5,10531500
43,2013-10-04,Grace Unplugged,1700000,2507159,2507159,2013,10,47.48,807159
45,2015-12-18,Saul fia,1700000,1777043,9696537,2015,12,470.38,7996537
46,2005-06-17,My Summer of Love,1700000,1000915,4727375,2005,6,178.08,3027375
47,2005-06-24,Yes,1700000,396035,661221,2005,6,-61.1,-1038779
48,2019-02-01,Braid,1660000,0,80745,2019,2,-95.14,-1579255
54,2010-10-15,N-Secure,1600000,2595644,2595644,2010,10,62.23,995644
55,2008-02-01,Sukkar banat,1600000,1060591,14253760,2008,2,790.86,12653760
57,2006-01-27,Bubble,1600000,145382,145382,2006,1,-90.91,-1454618
58,2005-09-23,Dil Jo Bhi Kahey...,1600000,129319,129319,2005,9,-91.92,-1470681
60,2014-09-26,Two Night Stand,1600000,15600,868081,2014,9,-45.74,-731919
61,2005-11-04,I Love Your Work,1600000,3264,3264,2005,11,-99.8,-1596736
63,2011-04-01,Insidious,1500000,54009150,99870886,2011,4,6558.06,98370886
64,2016-10-21,Moonlight,1500000,27854931,65245512,2016,10,4249.7,63745512
65,2003-09-12,Cabin Fever,1500000,21158188,30351664,2003,9,1923.44,28851664
66,2007-05-02,Waitress,1500000,19097550,22217183,2007,5,1381.15,20717183
70,2018-03-23,Unsane,1500000,7690044,14244931,2018,3,849.66,12744931
72,2005-10-05,The Squid and the Whale,1500000,7372734,11191423,2005,10,646.09,9691423
73,2002-03-13,Kissing Jessica Stein,1500000,7025722,9345061,2002,3,523.0,7845061
77,2013-07-26,The To Do List,1500000,3491669,4128828,2013,7,175.26,2628828
78,2013-02-01,The Gatekeepers,1500000,2408553,2592308,2013,2,72.82,1092308
81,2016-10-21,Iâm Not Ashamed,1500000,2082980,2082980,2016,10,38.87,582980
83,2002-04-19,Nueve Reinas,1500000,1222889,12412889,2002,4,727.53,10912889
84,2013-04-19,The Lords of Salem,1500000,1165881,1541131,2013,4,2.74,41131
85,2016-10-21,31,1500000,779820,922727,2016,10,-38.48,-577273
86,2005-03-25,The Ballad of Jack and Rose,1500000,712294,1126258,2005,3,-24.92,-373742
87,2016-04-22,Unsullied,1500000,510957,510957,2016,4,-65.94,-989043
89,2002-05-17,The Believer,1500000,406035,1840248,2002,5,22.68,340248
90,2008-03-07,Snow Angels,1500000,402858,414404,2008,3,-72.37,-1085596
91,2001-08-10,Session 9,1500000,378176,1619602,2001,8,7.97,119602
92,2011-02-11,MOOZ-lum,1500000,362239,372239,2011,2,-75.18,-1127761
93,2007-09-05,I Want Someone To Eat Cheese With,1500000,194568,194568,2007,9,-87.03,-1305432
94,2011-08-19,Amigo,1500000,184705,184705,2011,8,-87.69,-1315295
95,2007-09-07,Hatchet,1500000,175281,240396,2007,9,-83.97,-1259604
96,2008-10-31,My Name is Bruce,1500000,173066,173066,2008,10,-88.46,-1326934
97,2010-08-06,The Disappearance of Alice Creed,1500000,166980,1605139,2010,8,7.01,105139
99,2007-05-11,The Salon,1500000,139084,139084,2007,5,-90.73,-1360916
100,2013-10-25,The Square,1500000,124244,176262,2013,10,-88.25,-1323738
1,2002-03-22,Stolen Summer,1500000,119841,119841,2002,3,-92.01,-1380159
2,2015-03-06,Road Hard,1500000,113169,113169,2015,3,-92.46,-1386831
3,2005-09-28,Forty Shades of Blue,1500000,75828,172569,2005,9,-88.5,-1327431
4,2009-10-09,Trucker,1500000,52429,52429,2009,10,-96.5,-1447571
5,2009-05-29,Pontypool,1500000,3865,31916,2009,5,-97.87,-1468084
6,2015-09-28,"Me, You and Five Bucks",1500000,2105,2105,2015,9,-99.86,-1497895
7,2014-10-17,Housebound,1500000,0,236863,2014,10,-84.21,-1263137
8,2018-07-20,Teefa in Trouble,1500000,0,98806,2018,7,-93.41,-1401194
9,2005-11-04,Wal-Mart: The High Cost of Low Price,1500000,0,58692,2005,11,-96.09,-1441308
10,2014-04-17,Closer to the Moon,1500000,0,5396,2014,4,-99.64,-1494604
20,2018-11-30,Werk ohne Autor,1400000,1303747,4331152,2018,11,209.37,2931152
21,2015-11-20,Mustang,1400000,845464,5552584,2015,11,296.61,4152584
22,2005-04-29,The Holy Girl,1400000,304124,1261792,2005,4,-9.87,-138208
23,2014-10-03,La chambre bleue,1400000,260441,1945420,2014,10,38.96,545420
24,2004-09-17,Incident at Loch Ness,1400000,36830,56073,2004,9,-95.99,-1343927
25,2013-04-05,Eddie: The Sleepwalking Cannibal,1400000,1632,1632,2013,4,-99.88,-1398368
35,2009-05-22,The Girlfriend Experience,1300000,695840,1005840,2009,5,-22.63,-294160
36,2007-03-23,Journey from the Fall,1300000,635305,635305,2007,3,-51.13,-664695
37,2000-05-05,The Basket,1300000,609042,609042,2000,5,-53.15,-690958
38,2015-01-30,Above and Beyond,1300000,288751,288751,2015,1,-77.79,-1011249
40,2005-12-09,Neal n' Nikki,1300000,100358,329621,2005,12,-74.64,-970379
41,2003-12-19,The Hebrew Hammer,1300000,77755,90213,2003,12,-93.06,-1209787
42,2014-06-13,Los insolitos peces gato,1300000,11278,54665,2014,6,-95.8,-1245335
43,2006-04-07,Simon,1300000,4055,1738663,2006,4,33.74,438663
44,2011-05-24,Forget Me Not,1300000,0,13465,2011,5,-98.96,-1286535
51,2014-10-17,Dear White People,1250000,4404154,5403771,2014,10,332.3,4153771
52,2013-04-19,Filly Brown,1250000,2850357,2940411,2013,4,135.23,1690411
54,2016-12-31,Bodom,1250000,0,726460,2016,12,-41.88,-523540
57,2004-10-29,Saw,1200000,55968727,103880027,2004,10,8556.67,102680027
59,2002-02-15,Super Troopers,1200000,18492362,23046142,2002,2,1820.51,21846142
60,2002-02-22,Monsoon Wedding,1200000,13876974,27025600,2002,2,2152.13,25825600
61,2000-11-10,You Can Count on Me,1200000,9180275,10827356,2000,11,802.28,9627356
66,2013-04-19,Home Run,1200000,2859955,2859955,2013,4,138.33,1659955
68,2000-07-07,But I'm a Cheerleader,1200000,2205627,2509344,2000,7,109.11,1309344
72,2012-04-13,Blue Like Jazz,1200000,595018,595018,2012,4,-50.42,-604982
73,2015-08-28,Que Horas Ela Volta?,1200000,376976,3249041,2015,8,170.75,2049041
75,2003-03-21,Down & Out with the Dolls,1200000,58936,58936,2003,3,-95.09,-1141064
76,2012-06-01,"Pink Ribbons, Inc.",1200000,26608,26608,2012,6,-97.78,-1173392
77,2018-02-06,Blood Feast,1200000,8708,8708,2018,2,-99.27,-1191292
78,2011-02-11,Certifiably Jonathan,1200000,7826,7826,2011,2,-99.35,-1192174
79,2015-09-18,La navaja de Don Juan,1200000,4254,4254,2015,9,-99.65,-1195746
80,2008-12-31,Extreme Movie,1200000,0,81338,2008,12,-93.22,-1118662
90,2014-03-21,Godâs Not Dead,1150000,60755732,63777092,2014,3,5445.83,62627092
91,2005-10-07,Waiting...,1125000,16124543,18673274,2005,10,1559.85,17548274
92,2006-05-12,Dead Man's Shoes,1125000,6408,414736,2006,5,-63.13,-710264
94,2005-12-25,Wolf Creek,1100000,16186348,29005064,2005,12,2536.82,27905064
95,2005-02-11,Ong-Bak,1100000,4563167,24062965,2005,2,2087.54,22962965
96,2012-03-23,Serbuan maut,1100000,4105123,9297407,2012,3,745.22,8197407
99,2002-02-22,Sex with Strangers,1100000,247740,247740,2002,2,-77.48,-852260
100,2012-05-18,Beyond the Black Rainbow,1100000,56491,56491,2012,5,-94.86,-1043509
1,2003-05-14,Dracula: Pages from a Virgin's Diary,1100000,39659,81371,2003,5,-92.6,-1018629
2,2014-11-21,The Sleepwalker,1100000,2636,2636,2014,11,-99.76,-1097364
3,2017-03-07,Departure,1100000,0,27561,2017,3,-97.49,-1072439
9,2009-12-11,Rocket Singh: Salesman of the Year,1070000,164649,5348767,2009,12,399.88,4278767
12,2012-01-06,The Devil Inside,1000000,53262945,101759490,2012,1,10075.95,100759490
14,2015-04-17,Unfriended,1000000,32789645,64364198,2015,4,6336.42,63364198
16,2006-05-24,An Inconvenient Truth,1000000,24146161,53365925,2006,5,5236.59,52365925
17,2013-08-23,You're Next,1000000,18494006,26887177,2013,8,2588.72,25887177
18,2012-05-25,Chernobyl Diaries,1000000,18119640,42411721,2012,5,4141.17,41411721
22,2016-03-11,"Hello, My Name is Doris",1000000,14444999,14662703,2016,3,1366.27,13662703
23,2005-09-16,Cry Wolf,1000000,10047674,15943081,2005,9,1494.31,14943081
24,2000-08-18,Godzilla 2000,1000000,10037390,10037390,2000,8,903.74,9037390
25,2010-12-29,Blue Valentine,1000000,9737892,16566240,2010,12,1556.62,15566240
26,2006-01-20,Transamerica,1000000,9015303,16553163,2006,1,1555.32,15553163
29,2018-07-20,Unfriended: Dark Web,1000000,8866745,16434588,2018,7,1543.46,15434588
31,2015-09-25,The Green Inferno,1000000,7192291,12931420,2015,9,1193.14,11931420
32,2017-02-03,I Am Not Your Negro,1000000,7123919,9617402,2017,2,861.74,8617402
33,2012-10-19,The Sessions,1000000,6002451,11495204,2012,10,1049.52,10495204
34,2008-04-04,Shine a Light,1000000,5505267,16173879,2008,4,1517.39,15173879
35,2012-03-23,October Baby,1000000,5355847,5391992,2012,3,439.2,4391992
36,2014-09-12,The Skeleton Twins,1000000,5284309,5797192,2014,9,479.72,4797192
37,2013-06-14,20 Feet From Stardom,1000000,4946250,5892466,2013,6,489.25,4892466
38,2009-06-12,"Food, Inc.",1000000,4417674,4731944,2009,6,373.19,3731944
39,2017-07-28,An Inconvenient Sequel,1000000,3496795,5839322,2017,7,483.93,4839322
41,2014-06-06,Obvious Child,1000000,3122616,3324070,2014,6,232.41,2324070
42,2011-10-21,Martha Marcy May Marlene,1000000,2981038,5438911,2011,10,443.89,4438911
43,2005-08-03,Junebug,1000000,2678010,3553253,2005,8,255.33,2553253
44,2008-08-01,Frozen River,1000000,2511476,6030129,2008,8,503.01,5030129
45,2001-11-21,Sidewalks of New York,1000000,2402459,3575308,2001,11,257.53,2575308
47,2000-09-29,The Broken Hearts Club: A Romantic Comedy,1000000,1744858,2022442,2000,9,102.24,1022442
48,2006-06-28,Who Killed the Electric Car?,1000000,1678874,1849392,2006,6,84.94,849392
49,2009-09-18,The Secrets of Jonathan Sperry,1000000,1355079,1355079,2009,9,35.51,355079
51,2003-09-19,Bubba Ho-Tep,1000000,1239183,1492895,2003,9,49.29,492895
52,2001-12-07,No Man's Land,1000000,1067481,2684207,2001,12,168.42,1684207
54,2017-10-06,Visages villages,1000000,952432,4015686,2017,10,301.57,3015686
55,2001-04-06,Brigham City,1000000,852206,852206,2001,4,-14.78,-147794
56,2017-08-18,Patti Cake$,1000000,800148,1471090,2017,8,47.11,471090
57,2000-12-01,Panic,1000000,779137,1425707,2000,12,42.57,425707
58,2014-05-09,Palo Alto,1000000,767732,1156309,2014,5,15.63,156309
59,2000-09-08,Fiza,1000000,623791,1179462,2000,9,17.95,179462
60,2010-02-03,Ajami,1000000,621859,2721096,2010,2,172.11,1721096
62,2011-07-29,The Future,1000000,568662,1239174,2011,7,23.92,239174
63,2003-02-14,All the Real Girls,1000000,549666,703020,2003,2,-29.7,-296980
64,2014-10-24,23 Blast,1000000,549185,549185,2014,10,-45.08,-450815
66,2013-07-19,The Act of Killing,1000000,486919,1227316,2013,7,22.73,227316
67,2003-05-02,Blue Car,1000000,464126,475367,2003,5,-52.46,-524633
68,2007-10-19,Wristcutters: A Love Story,1000000,446165,473769,2007,10,-52.62,-526231
69,2000-05-05,Luminarias,1000000,428535,428535,2000,5,-57.15,-571465
70,2014-07-18,I Origins,1000000,336472,852399,2014,7,-14.76,-147601
71,2014-11-28,Antarctica: A Year on Ice,1000000,288757,288757,2014,11,-71.12,-711243
72,2003-08-22,The Battle of Shaker Heights,1000000,280351,839145,2003,8,-16.09,-160855
73,2008-01-18,Taxi to the Dark Side,1000000,274661,304472,2008,1,-69.55,-695528
74,2016-04-08,The Invitation,1000000,231738,354836,2016,4,-64.52,-645164
75,2004-09-24,Guiana 1838,1000000,227241,227241,2004,9,-77.28,-772759
76,2002-12-30,Love Liza,1000000,213137,213137,2002,12,-78.69,-786863
77,2006-07-07,Once in a Lifetime: the Extraordinary Story of the New York Cosmos,1000000,144601,215559,2006,7,-78.44,-784441
78,2001-08-22,Lisa Picard is Famous,1000000,113433,113433,2001,8,-88.66,-886567
79,2015-07-31,Beyond the Brick: A LEGO Brickumentary,1000000,101531,101531,2015,7,-89.85,-898469
80,2009-10-30,The House of the Devil,1000000,101215,102812,2009,10,-89.72,-897188
81,2012-06-01,Hardflip,1000000,96734,96734,2012,6,-90.33,-903266
82,2016-03-11,Creative Control,1000000,63014,63014,2016,3,-93.7,-936986
83,2005-09-16,Chocolate: Deep Dark Secrets,1000000,49000,1549000,2005,9,54.9,549000
84,2011-07-01,The Perfect Host,1000000,48764,51587,2011,7,-94.84,-948413
87,2001-08-31,Speedway Junky,1000000,17127,17127,2001,8,-98.29,-982873
88,2015-02-13,Hits,1000000,15156,15156,2015,2,-98.48,-984844
89,2000-09-22,The Specials,1000000,12996,12996,2000,9,-98.7,-987004
90,2010-09-03,16 to Life,1000000,11574,11574,2010,9,-98.84,-988426
91,2007-01-17,Alone with Her,1000000,10787,844377,2007,1,-15.56,-155623
92,2014-10-17,Camp X-Ray,1000000,9837,101053,2014,10,-89.89,-898947
93,2008-11-21,Special,1000000,7202,26822,2008,11,-97.32,-973178
94,2015-04-10,The Sisterhood of Night,1000000,6870,6870,2015,4,-99.31,-993130
96,2005-03-18,The Helixâ¦Loaded,1000000,3700,3700,2005,3,-99.63,-996300
97,2015-05-15,Childless,1000000,1036,1036,2015,5,-99.9,-998964
98,2006-04-21,In Her Line of Fire,1000000,884,884,2006,4,-99.91,-999116
99,2002-12-13,The Jimmy Show,1000000,703,703,2002,12,-99.93,-999297
100,2013-12-31,Heli,1000000,0,552614,2013,12,-44.74,-447386
1,2015-12-31,Karachi se Lahore,1000000,0,17721,2015,12,-98.23,-982279
2,2006-12-31,Loving Annabelle,1000000,0,5382,2006,12,-99.46,-994618
27,2007-06-01,And Then Came Love,989000,8158,8158,2007,6,-99.18,-980842
28,2006-04-14,Hard Candy,950000,1024640,8267066,2006,4,770.22,7317066
29,2002-09-27,Charly,950000,814666,814666,2002,9,-14.25,-135334
30,2014-01-10,Banshee Chapter,950000,0,78122,2014,1,-91.78,-871878
34,2012-04-13,L!fe Happens,930000,30905,30905,2012,4,-96.68,-899095
35,2017-05-12,Lowriders,916000,6179955,6188421,2017,5,575.59,5272421
36,2014-11-21,Food Chains,913000,0,176,2014,11,-99.98,-912824
38,2013-07-12,Fruitvale Station,900000,16098998,17549645,2013,7,1849.96,16649645
39,2016-04-01,Meet the Blacks,900000,9097072,9097072,2016,4,910.79,8197072
40,2008-01-25,"4 luni, 3 saptamani si 2 zile",900000,1196321,11993156,2008,1,1232.57,11093156
41,2011-08-26,Circumstance,900000,454121,958978,2011,8,6.55,58978
42,2006-08-25,The Quiet,900000,381420,381420,2006,8,-57.62,-518580
43,2012-04-27,The Giant Mechanical Man,900000,7396,7396,2012,4,-99.18,-892604
44,2013-04-05,The Brass Teapot,900000,6997,413733,2013,4,-54.03,-486267
48,2012-08-31,"For a Good Time, Call",850000,1251749,1386088,2012,8,63.07,536088
49,2004-01-30,Latter Days,850000,833118,865708,2004,1,1.85,15708
50,2008-03-21,The Hammer,850000,442638,442638,2008,3,-47.92,-407362
51,2015-08-28,Windsor Drive,850000,3256,3256,2015,8,-99.62,-846744
54,2012-08-03,Celeste and Jesse Forever,840000,3103407,3787689,2012,8,350.92,2947689
55,2002-10-25,Time Changer,825000,1500711,1500711,2002,10,81.9,675711
56,2009-08-11,London to Brighton,825000,0,610776,2009,8,-25.97,-214224
57,2009-12-31,Crying With Laughter,820000,0,16909,2009,12,-97.94,-803091
59,2011-12-30,Jodaeiye Nader az Simin,800000,7098492,24426169,2011,12,2953.27,23626169
61,2003-03-28,Raising Victor Vargas,800000,2073984,2900578,2003,3,262.57,2100578
63,2002-08-09,Pandora's Box,800000,881950,881950,2002,8,10.24,81950
64,2007-07-18,Cama adentro,800000,200433,200433,2007,7,-74.95,-599567
65,2000-03-10,Deterrence,800000,144583,371647,2000,3,-53.54,-428353
66,2004-05-07,The Mudge Boy,800000,62544,62544,2004,5,-92.18,-737456
67,2003-04-11,The Young Unknowns,800000,58163,58163,2003,4,-92.73,-741837
68,2009-06-19,DÃ¸d snÃ¸,800000,46742,2194020,2009,6,174.25,1394020
69,2014-09-19,Not Cool,800000,35688,35688,2014,9,-95.54,-764312
70,2012-02-03,Kill List,800000,29063,462206,2012,2,-42.22,-337794
72,2004-08-06,Saints and Soldiers,780000,1310470,1310470,2004,8,68.01,530470
75,2011-09-09,Kevin Hart: Laugh at My Pain,750000,7706436,7712436,2011,9,928.32,6962436
76,2007-04-13,Aqua Teen Hunger Force Colon Movie Film for Theaters,750000,5520368,5520368,2007,4,636.05,4770368
77,2012-06-08,Safety Not Guaranteed,750000,4010957,4422318,2012,6,489.64,3672318
78,2012-02-03,The Innkeepers,750000,78396,1011535,2012,2,34.87,261535
79,2014-08-29,Il conformista,750000,59656,89609,2014,8,-88.05,-660391
80,2002-11-15,Interview with the Assassin,750000,47329,47329,2002,11,-93.69,-702671
81,2005-07-01,Undead,750000,41196,229250,2005,7,-69.43,-520750
82,2009-01-23,Donkey Punch,750000,19367,814801,2009,1,8.64,64801
83,2013-10-11,All the Boys Love Mandy Lane,750000,0,1960521,2013,10,161.4,1210521
84,2014-12-31,Destiny,750000,0,450,2014,12,-99.94,-749550
90,2005-06-24,Rize,700000,3278611,4857731,2005,6,593.96,4157731
91,2006-08-11,Half Nelson,700000,2697938,4911725,2006,8,601.67,4211725
92,2001-09-07,L.I.E.,700000,1140965,1140965,2001,9,63.0,440965
93,2017-08-04,Columbus,700000,1017107,1110511,2017,8,58.64,410511
95,2010-01-26,B-Girl,700000,0,1160,2010,1,-99.83,-698840
100,2013-10-11,Escape from Tomorrow,650000,171962,171962,2013,10,-73.54,-478038
1,2018-12-14,That Way Madness Lies,650000,1447,1447,2018,12,-99.78,-648553
4,2009-12-31,Starsuckers,640000,0,14812,2009,12,-97.69,-625188
11,2000-10-31,Mercy Streets,600000,173599,173599,2000,10,-71.07,-426401
12,2014-05-02,Water & Power,600000,42557,42557,2014,5,-92.91,-557443
13,2007-10-19,Arnolds Park,600000,23616,23616,2007,10,-96.06,-576384
15,2015-05-22,Drunk Wedding,600000,3301,3301,2015,5,-99.45,-596699
16,2016-03-04,They Will Have to Kill Us First,600000,0,7943,2016,3,-98.68,-592057
22,2011-07-29,The Harvest/La Cosecha,560000,3709,3709,2011,7,-99.34,-556291
23,2015-12-31,Julija in alfa Romeo,560000,0,8462,2015,12,-98.49,-551538
27,2014-09-12,Faith Connections,550000,9111,9111,2014,9,-98.34,-540889
29,2008-09-26,Fireproof,500000,33456317,33473297,2008,9,6594.66,32973297
31,2004-08-06,Open Water,500000,30500882,55518641,2004,8,11003.73,55018641
33,2005-05-13,Mad Hot Ballroom,500000,8117961,9387581,2005,5,1777.52,8887581
34,2003-10-03,The Station Agent,500000,5801558,9470209,2003,10,1794.04,8970209
35,2010-01-22,To Save a Life,500000,3777210,3824868,2010,1,664.97,3324868
36,2006-06-16,Wordplay,500000,3121270,3177636,2006,6,535.53,2677636
38,2002-02-01,The Singles Ward,500000,1250798,1250798,2002,2,150.16,750798
39,2011-07-08,Sholem Aleichem: Laughing in the Darkness,500000,1131261,1131261,2011,7,126.25,631261
40,2004-01-30,Osama,500000,1127331,1971479,2004,1,294.3,1471479
41,2000-06-09,Groove,500000,1115313,1167524,2000,6,133.5,667524
42,2003-01-31,The R.M.,500000,1111615,1111615,2003,1,122.32,611615
44,2004-08-20,Mean Creek,500000,603951,1348750,2004,8,169.75,848750
45,2013-08-23,Drinking Buddies,500000,343706,407100,2013,8,-18.58,-92900
47,2002-07-12,Never Again,500000,307631,308793,2002,7,-38.24,-191207
49,2003-08-29,Civil Brand,500000,254293,254293,2003,8,-49.14,-245707
50,2010-10-29,Monsters,500000,237301,5639730,2010,10,1027.95,5139730
51,2006-03-24,Lonesome Jim,500000,154187,602789,2006,3,20.56,102789
52,2013-04-17,Deceptive Practice: The Mysteries and Mentors of Ricky Jay,500000,152449,152449,2013,4,-69.51,-347551
53,2012-09-28,The Other Dream Team,500000,134109,314444,2012,9,-37.11,-185556
54,2015-12-11,O Menino e o Mundo,500000,129479,280967,2015,12,-43.81,-219033
55,2011-04-01,Rubber,500000,100370,680914,2011,4,36.18,180914
57,2007-10-05,Finishing the Game,500000,52850,53201,2007,10,-89.36,-446799
58,2008-04-18,Kiss the Bride,500000,32033,32033,2008,4,-93.59,-467967
59,2003-07-11,The Journey,500000,19800,19800,2003,7,-96.04,-480200
60,2009-04-23,Home,500000,15433,44793168,2009,4,8858.63,44293168
61,2003-01-10,The Slaughter Rule,500000,13134,13134,2003,1,-97.37,-486866
62,2010-05-14,The Living Wake,500000,12232,12232,2010,5,-97.55,-487768
63,2009-02-27,Scott Walker: 30 Century Man,500000,6840,77121,2009,2,-84.58,-422879
64,2005-10-21,The Californians,500000,4134,4134,2005,10,-99.17,-495866
65,2014-09-10,Born to Fly: Elizabeth Streb vs. Gravity,500000,1822,1822,2014,9,-99.64,-498178
66,2013-06-28,Detention of the Dead,500000,1778,1778,2013,6,-99.64,-498222
67,2018-05-11,Higher Power,500000,528,528,2018,5,-99.89,-499472
68,2006-12-31,Feng kuang de shi tou,500000,0,3000000,2006,12,500.0,2500000
69,2013-01-08,Now is Good,500000,0,2141436,2013,1,328.29,1641436
70,2006-12-31,Griffin & Phoenix,500000,0,1355967,2006,12,171.19,855967
71,2001-11-02,Everything Put Together,500000,0,7890,2001,11,-98.42,-492110
93,2009-09-25,Paranormal Activity,450000,107918810,194183034,2009,9,43051.79,193733034
95,2006-03-31,Brick,450000,2075743,4243996,2006,3,843.11,3793996
97,2006-08-11,Conversations with Other Women,450000,379418,1297745,2006,8,188.39,847745
98,2015-11-20,Siakh lokhamim: ha'slilim ha'gnouzim,450000,41260,42503,2015,11,-90.55,-407497
99,2008-05-09,Poultrygeist: Night of the Chicken Dead,450000,13804,22623,2008,5,-94.97,-427377
100,2014-07-11,As It Is in Heaven,450000,13486,13486,2014,7,-97.0,-436514
5,2006-04-28,Moartea domnului Lazarescu,425000,80301,581304,2006,4,36.78,156304
6,2005-01-21,Gory Gory Hallelujah,425000,12604,12604,2005,1,-97.03,-412396
7,2014-04-25,Blue Ruin,420000,258384,437002,2014,4,4.05,17002
8,2004-06-11,Napoleon Dynamite,400000,44540956,46122713,2004,6,11430.68,45722713
10,2006-08-02,Quinceanera,400000,1692693,2797199,2006,8,599.3,2397199
11,2002-04-26,Dogtown and Z-Boys,400000,1293295,1600566,2002,4,300.14,1200566
12,2008-10-24,Heroes,400000,655538,655538,2008,10,63.88,255538
13,2004-10-06,Tarnation,400000,592014,1162014,2004,10,190.5,762014
14,2010-10-15,I Want Your Money,400000,433588,433588,2010,10,8.4,33588
17,2001-07-27,Jackpot,400000,44452,44452,2001,7,-88.89,-355548
18,2004-12-10,Fabled,400000,31425,31425,2004,12,-92.14,-368575
19,2005-10-13,The Dark Hours,400000,423,423,2005,10,-99.89,-399577
20,2015-03-31,Viskningar och rop,400000,0,9071,2015,3,-97.73,-390929
30,2005-07-08,Murderball,350000,1531154,1772979,2005,7,406.57,1422979
31,2010-09-01,My Dog Tulip,350000,246574,310891,2010,9,-11.17,-39109
32,2006-10-18,51 Birch Street,350000,84689,84689,2006,10,-75.8,-265311
33,2002-11-15,Revolution#9,350000,9118,9118,2002,11,-97.39,-340882
39,2010-06-25,Kynodontas,323000,110248,1373407,2010,6,325.2,1050407
41,2003-11-14,Tupac Resurrection,300000,7718961,7808524,2003,11,2502.84,7508524
42,2000-03-10,God's Army,300000,2637726,2652515,2000,3,784.17,2352515
43,2003-10-17,Pieces of April,300000,2528664,3571253,2003,10,1090.42,3271253
45,2008-12-10,Wendy and Lucy,300000,865695,1416046,2008,12,372.02,1116046
47,2006-08-25,Old Joy,300000,255923,399908,2006,8,33.3,99908
48,2005-07-15,First Morning,300000,87264,87264,2005,7,-70.91,-212736
49,2007-06-15,Pierrot le fou,300000,70807,71380,2007,6,-76.21,-228620
51,2011-03-11,3 Backyards,300000,39475,39475,2011,3,-86.84,-260525
52,2006-04-12,Sisters in Law,300000,33312,33312,2006,4,-88.9,-266688
53,2012-11-09,Nothing But a Man,300000,17241,17241,2012,11,-94.25,-282759
54,2002-07-19,Ayurveda: Art of Being,300000,16892,2066892,2002,7,588.96,1766892
56,2005-05-06,Fighting Tommy Riley,300000,10514,10514,2005,5,-96.5,-289486
57,2014-03-28,Locker 13,300000,3496,3496,2014,3,-98.83,-296504
58,2015-10-23,The Looking Glass,300000,1711,1711,2015,10,-99.43,-298289
59,2014-10-31,All You Need Is Love,300000,0,3565259,2014,10,1088.42,3265259
68,2012-08-17,Compliance,270000,319285,830700,2012,8,207.67,560700
71,2002-06-28,Lovely and Amazing,250000,4210379,4613482,2002,6,1745.39,4363482
72,2017-04-28,Sleight,250000,3930990,3934450,2017,4,1473.78,3684450
73,2003-04-11,Better Luck Tomorrow,250000,3802390,3809226,2003,4,1423.69,3559226
74,2011-10-28,Like Crazy,250000,3395391,3728400,2011,10,1391.36,3478400
76,2000-07-14,Chuck&Buck,250000,1055671,1157672,2000,7,363.07,907672
77,2001-03-16,American Desi,250000,902835,1366235,2001,3,446.49,1116235
81,2005-07-22,November,250000,191862,191862,2005,7,-23.26,-58138
83,2008-03-28,Happy Valley,250000,67665,67665,2008,3,-72.93,-182335
84,2013-08-02,The Canyons,250000,59671,62375,2013,8,-75.05,-187625
85,2006-06-28,The Motel,250000,51540,51540,2006,6,-79.38,-198460
86,2005-07-15,On the Outs,250000,49772,237816,2005,7,-4.87,-12184
87,2007-12-14,Shotgun Stories,250000,46026,284174,2007,12,13.67,34174
88,2014-08-15,Nightlights,250000,21147,21147,2014,8,-91.54,-228853
89,2014-06-06,Test,250000,18823,18823,2014,6,-92.47,-231177
91,2015-03-24,Along the Roadside,250000,0,3234,2015,3,-98.71,-246766
8,2008-10-31,Little Big Top,240000,7484,7484,2008,10,-96.88,-232516
9,2009-10-09,Bronson,230000,104979,2703762,2009,10,1075.55,2473762
10,2012-07-20,Burn,225000,1109276,1109276,2012,7,393.01,884276
11,2000-09-15,Urbania,225000,1032075,1032075,2000,9,358.7,807075
18,2011-02-25,The Grace Card,200000,2430735,2430735,2011,2,1115.37,2230735
20,2000-02-11,Trois,200000,1161843,1161843,2000,2,480.92,961843
21,2015-06-19,The Overnight,200000,1109808,1165996,2015,6,483.0,965996
22,2004-10-22,Short Cut to Nirvana: Kumbh Mela,200000,381225,439651,2004,10,119.83,239651
23,2012-10-12,Middle of Nowhere,200000,236806,236806,2012,10,18.4,36806
24,2008-10-10,Call+Response,200000,212989,212989,2008,10,6.49,12989
25,2002-05-10,The Business of Fancy Dancing,200000,174682,174682,2002,5,-12.66,-25318
26,2002-05-10,Hybrid,200000,162605,162605,2002,5,-18.7,-37395
27,2008-06-13,Baghead,200000,140016,140016,2008,6,-29.99,-59984
28,2004-09-10,Malevolence,200000,126021,346106,2004,9,73.05,146106
29,2005-09-09,Side Effects,200000,44701,44701,2005,9,-77.65,-155299
30,2008-10-10,Good Dick,200000,28835,52443,2008,10,-73.78,-147557
31,2006-07-21,The Case of the Grinning Cat,200000,7033,7033,2006,7,-96.48,-192967
32,2005-01-07,Solitude,200000,6260,6260,2005,1,-96.87,-193740
33,2014-03-14,The Word,200000,3648,3648,2014,3,-98.18,-196352
34,2007-06-15,The Trials of Darryl Hunt,200000,1217,1217,2007,6,-99.39,-198783
43,2011-09-23,Weekend,190000,484592,1577585,2011,9,730.31,1387585
45,2015-02-27,Butterfly Girl,180000,17503,17503,2015,2,-90.28,-162497
48,2011-07-22,Another Earth,175000,1321194,2102779,2011,7,1101.59,1927779
49,2013-08-23,Sparrows Dance,175000,2602,2602,2013,8,-98.51,-172398
51,2016-06-03,The Fits,170000,166425,169242,2016,6,-0.45,-758
53,2015-12-31,Lumea e a mea,168000,0,29678,2015,12,-82.33,-138322
54,2009-09-11,The Horse Boy,160000,156612,156612,2009,9,-2.12,-3388
55,2002-03-01,The Calling,160000,32092,32092,2002,3,-79.94,-127908
57,2007-05-16,Once,150000,9445857,23323631,2007,5,15449.09,23173631
58,2002-07-19,Tadpole,150000,2891288,3270128,2002,7,2080.09,3120128
59,2000-06-23,The Woman Chaser,150000,110719,110719,2000,6,-26.19,-39281
60,2015-04-17,Antarctic Edge: 70Âº South,150000,7193,7193,2015,4,-95.2,-142807
61,2015-08-21,Top Spin,150000,5858,5858,2015,8,-96.09,-144142
62,2013-12-31,Speak No Evil,150000,0,32927,2013,12,-78.05,-117073
68,2012-04-27,Sound of My Voice,135000,408015,429448,2012,4,218.11,294448
73,2012-06-15,Your Sister's Sister,120000,1597486,3090593,2012,6,2475.49,2970593
79,2003-10-03,The Work and the Story,103000,16137,16137,2003,10,-84.33,-86863
80,2015-07-10,The Gallows,100000,22764410,41656474,2015,7,41556.47,41556474
81,2006-09-29,Facing the Giants,100000,10178331,10243159,2006,9,10143.16,10143159
86,2017-07-07,A Ghost Story,100000,1594798,2769782,2017,7,2669.78,2669782
88,2004-02-06,The Lost Skeleton of Cadavra,100000,110536,110536,2004,2,10.54,10536
89,2014-03-21,Cheap Thrills,100000,59424,59424,2014,3,-40.58,-40576
90,2014-06-19,The Past is a Grotesque Animal,100000,20056,20056,2014,6,-79.94,-79944
91,2001-11-09,Keeping it Real: The Adventures of Greg Walloch,100000,1358,1358,2001,11,-98.64,-98642
1,2008-05-30,The Foot Fist Way,79000,234286,234286,2008,5,196.56,155286
2,2015-07-17,Dawn of the Crescent Moon,75000,8799,8799,2015,7,-88.27,-66201
4,2014-07-25,Happy Christmas,70000,30312,30312,2014,7,-56.7,-39688
5,2005-01-28,"Peace, Propaganda and the Promised Land",70000,4930,4930,2005,1,-92.96,-65070
6,2011-12-31,Absentia,70000,0,8555,2011,12,-87.78,-61445
10,2004-05-07,Super Size Me,65000,11529368,22233808,2004,5,34105.86,22168808
11,2013-01-25,Supporting Characters,60000,4917,4917,2013,1,-91.8,-55083
17,2001-03-16,Gabriela,50000,2335352,2335352,2001,3,4570.7,2285352
18,2010-11-12,Tiny Furniture,50000,391674,424149,2010,11,748.3,374149
19,2008-02-22,The Signal,50000,251150,406299,2008,2,712.6,356299
20,2015-07-31,Counting,50000,8374,8374,2015,7,-83.25,-41626
28,2000-10-27,George Washington,42000,241816,342722,2000,10,716.0,300722
30,2000-08-25,Smiling Fish and Goat on Fire,40000,277233,277233,2000,8,593.08,237233
31,2010-03-12,The Exploding Girl,40000,25572,25572,2010,3,-36.07,-14428
32,2011-02-11,Raymond Did It,40000,3632,3632,2011,2,-90.92,-36368
37,2008-07-18,The Legend of God's Gun,30000,243768,243768,2008,7,712.56,213768
38,2016-03-18,Krisha,30000,144822,144822,2016,3,382.74,114822
39,2006-09-01,Mutual Appreciation,30000,103509,103509,2006,9,245.03,73509
40,2005-04-29,Funny Ha Ha,30000,77070,82698,2005,4,175.66,52698
41,2010-10-15,Down Terrace,30000,9812,9812,2010,10,-67.29,-20188
45,2017-01-27,Emily,27000,3547,3547,2017,1,-86.86,-23453
48,2000-01-14,The Terrorist,25000,195043,195043,2000,1,680.17,170043
49,2015-09-01,Exeter,25000,0,489792,2015,9,1859.17,464792
60,2006-06-02,The Puffy Chair,15000,194523,195254,2006,6,1201.69,180254
61,2010-04-02,Breaking Upwards,15000,115592,115592,2010,4,670.61,100592
64,2006-04-28,Grip: A Criminal's Story,12000,1336,1336,2006,4,-88.87,-10664
66,2001-03-09,Dayereh,10000,673780,673780,2001,3,6637.8,663780
67,2006-04-28,Clean,10000,138711,138711,2006,4,1287.11,128711
68,2001-07-06,Cure,10000,94596,94596,2001,7,845.96,84596
69,2004-05-28,On the Downlow,10000,1987,1987,2004,5,-80.13,-8013
71,2008-08-14,The Rise and Fall of Miss Thang,10000,401,401,2008,8,-95.99,-9599
73,2012-01-13,Newlyweds,9000,4584,4584,2012,1,-49.07,-4416
75,2004-10-08,Primer,7000,424760,841926,2004,10,11927.51,834926
76,2006-05-26,Cavite,7000,70071,71644,2006,5,923.49,64644
77,2004-12-31,The Mongol King,7000,900,900,2004,12,-87.14,-6100
80,2005-07-13,Return to the Land of Wonders,5000,1338,1338,2005,7,-73.24,-3662
82,2005-08-05,My Date With Drew,1100,181041,181041,2005,8,16358.27,179941
